......................................................................................
........?.............................................................................
.......[@]............................................................................
.......[]]............................................................................
....[@@@@@@@].........................................................................
....[]/...\[].........................................................................
.?..[].....[].........................................................................
@@@@[].....[]..?......................................................................
...\[].....[]@@@@@]...................................................................
....[].....[]@@@@[]............@@@@@..................................................
....[].....[/....\].............|.|...................................................
....II.....]......].............|.|...................................................
....II.....I......I.............|.|...................................................
....II.....I......I.............|.|...................................................
....II.....I......I............+++++..................................................
@@@@@@@@@@@@@@@@@@@@@@@@@@@@@@@#####@@@@@@@@@@@@@@@@@@@@@@@@@@@@@@@@@@@@@@@@@@@@@@@@@@

