........................................................................................................................................................
........?...............................................................................................................................................
.......[@]..............................................................................................................................................
.......[]]................................................................@@@@@@@@@@@@@....@@@@@@@@@@@@@.............@@.................................
....[@@@@@@@].............................................................@@..........................@@.............@@.................................
....[]/...\[].............................................................@@..........................@@.............@@.................................
.?..[].....[]...........................................................@@@@..........................@@.............@@.................................
@@@@[].....[]..?........................................................@@@@@@@@@@@@@@......@@@@@@@@@@@@@@@@-----@@@@@@.................................
...\[].....[]@@@@@]...............................................@@@@@@@@@@..........................................I.................................
....[].....[]@@@@[]...............................................@@....@@............................................I.................................
....[].....[/....\]...............................................@@....@@............................................I.................................
....II.....]......].........................................------@@....@@.....@@@@@@@@....@@@@@@@@@@@@...............@@@@@@@@@@@@@@@@@@@@@@@@@@@@@@@@@@
....II.....I......I......................+++++++++++.................................@@....@@@@@@@@@@@@@@...........@@@@@@@@@@@@@@@@@@@@@@@@@@@@@@@@@@@@
....II.....I......I.................+++++###########++...............................@@....@@@@@@@@@@@@@@@@.......@@@@@@@@@@@@@@@@@@@@@@@@@@@@@@@@@@@@@@
....II.....I......I............+++++#############@@@@@@@@............................@@....@@@@@@@@@@@@@@@@@@...@@@@@@@@@@@@@@@@@@@@@@@@@@@@@@@@@@@@@@@@
@@@@@@@@@@@@@@@@@@@@@@@@@@@@@@@################@@@@@@@@@@@@@@@@@@@@@@@@@@@@@@@@@@@@@@@@....@@@@@@@@@@@@@@@@@@...@@@@@@@@@@@@@@@@@@@@@@@@@@@@@@@@@@@@@@@@

