........................................................................................................................................................................................................................................@@......@@..............@@..............................@@..@@.........................................................@@..@@..@@..............................................?........................................@@@@@@@@@@@@@@@@@@@@@@@@@@@@@@@@@@@@@@@@@@@@@@@@@@@@@@@@@@@......@@...........................................................................@@@@@@@@@@@@..................@@....@@....@@....@@....@@....@@....@@..@@....@@....@@....@@....@@....@@....@@..........................................@@..@@..@@..@@..@@..@@..@@..@@..@@............................................................................................................++++++++++++++....+++++++++++++++++++++.........++++++++++++...............................@@.................................................
........................................................................................................................................................................................................................................@@.k....@@@@..........@@@@@@............................@@@@@@.........................................................@@@@@@@@@@.............................................@@......@@................................@@...............................................................@@...........................................................................@@@@@/\@@@@@..................@@@@@@@@@@@@@@@@@@@@@@@@@@@@@@@@@@@@@@@@@@@@@@@@@@@@@@@@@@@@@@@@@@@@@@@@@@@@@@..........................................@@@@@@@@@@@@@@@@@@@@@@@@@@@@@@@@@@.........................................................................................................+++##############++++#####################+++++++++############++.............................@@.........+++++++++...............................
........................................................................................................................................................................................................................................@@...@@@@@@@@@@@@@@@@@@@@@@@@@@@@@@@@@@@@@..............@@@@@@.........................................................@@@@@@@@@@.............................................@@......@@@@@@@@@@@@@@@@@@@@@@@@@@@@@@@@@@@@...............................................................@@...........................................................................@@@@]..[@@@@------------------@@@@@@@@@@@@@@@@@@@@@@@@@@@@@@@@@@@@@@@@@@@@@@@@@@@@@@@@@@@@@@@@@@@@@@@@@@@@@@..........................................@@@@@@@@@@@@@@@@@@@@@@@@@@@@@@@@@@........................................................................................................+##########=======#####===================###########==========###+++++................@@......@@...++++++#########++++++.........................
..............................................................................................................?.........................................................................................................................@@@@@@@@@@@@@@@@@@@@@@@@@@@@@@@@@@@@@@@@@@@@............@@/\@@.........................................................@@@@/\@@@@.............................................@@.wx...@@...............................................................................................@@@@...........................................................................@@@@]..[@@@@........................................@@@@@@@@@@@@@@@@@@@@@@@@@@@@@@@.......................@@..........................................@@@.............................@@........................................................................................................#########===.....================================================######+++++++++.......@@......@@+++#######=======#######++++++...................
.............................................................................................................@@..@@.....................................................................................................................@@@@@@@@@@@@@@@@@@@@@@@@@@@@@@@@@@@@@@@@@@@@@...........@@..@@.........................................................@@@]..[@@@.............................................@@......@@..............................................................................................................................................................................@@@@@@@@@@@@........................................@@@@@@@@@@@@@@@@@@@@@@@@@@@@@@@.....l.................@@..........................................@@@.............................@@............................@@@@.......................................................................+######=====.........{........==========================....{.....=====##########+++++++@@....@@@@####===================#######++++...............
.............................................................................................................@@@@@@.............................................................................................................................................................................@@..@@.........................................................@@@]..[@@@.............................................@@@@@@@@@@..................................................................................@@..........................................................................................@@@@@@@@@@@@........................................@@@@@@@@@@@@@@@@@@@@@@@@@@@@@@@.......................@@..........................................@@@.............................@@............................@@.........................................................................####====...{....................{........======.....{................===========########@@......@@=============================#####+++............
................@@..@@..@@..@@...............................................................................@@@@@@......................................................................................................................................................................@@@@...@@@@@@.........................................................@@@@@@@@@@.........................................................................................................................................@@......@@@@@@@@@...............................................................................................................................@@@@@@@@@@@@@@@@@@@@@@@@@@@@@@@....@@@@@@@@@@@@@......@@...........................................2.......................................................@@@@@@@............@@@@...........................................................#===.......................................{...........................===============@@......@@========..{.....{.===============####+...........
................@@@@@@@@@@@@@@...............................................................................@@@@@@.............................................................................................................................................................................@@@@@@.........................................................@@@@@@@@@@............................................................@@@@@@@@@@@@@@@@@@@@@@@@@@@@@@@@@@@@@@@@@@@@@@@@@@@@@@@@@@@@@@@@@@@@@........@@.............@@...............................................................................................................................@@@@@@@@@@@@@@@@@@@@@@@@@@@@@@@....@@@@@@@@@@@@@@.....@@...........................................2............................................................@@............@@@@..........................................................................................................................................=======@@......@@.....{..................{....{..=====#...........
.................@@@@@@@@@@@@................................................................................@@@@@@.............................................................................................................................................................................@@@@@@.........................................................@@@@@@@@@@.........................................................................................................................................@@@@...........@@.....................................................................................................................................................................................@@...........................................2............................................................@@..........@@@@@@@@...............................................................................................................................................@@@@....@@....................................==...........
.................@@@.......................................................................................................................................................................................................................................................@@@@@@@@@@@@.........@@@@@@.........................................................@@@@@@@@@@.........................................................................................................................................@@.............@@...................................................................................................................................................................................@@@@...........................................2...................................................X........@@..........@@@@@@@@...............................................................................................................................................@@.........................................................
..................I................................................@@@@.........................................................................................................................................................................................................................@@@@@@.........................................................@@@@@@@@@@.................................................................................................l.......................................@@.............@@............................................@@------------.----------------@@@@@@@@@@@@-----------------@@........................................................................@@@@@..........................................@@@.............................@@...................X........@@......@@@@@@@@@@@@@@@@@@.............@@.................................+++=.....................................................................................@@.........................................................
..................I................................................@@@@.................@@@@..................................................................................................................................................@@@@@@@@@@@@@@@@@@@@@@...........................................................................................@@@@@@@@@@.............................................@@@@@@@@@@@@@.....................................................................@@@@@@@@@@@@@@@@@@@@.....@@...........................................@@@.............................@@@@@@@@@@@@.................@@@@................@@@@@@@@@@@@@@@@@@@@@@@@@@@@@@@@@@@..@@@@@@@@@@@@@@@@@@@@@@.......................................XXX@@@...........................==@@XXXXXX............XXX.......@@............@@@@@@@@@@@@----------.--@@@@..............................+###==...............................................................................................................................................
..................I.................................@@@@@@.....@@@@@@@@......@@@@@@.....@@@@................@@@@@@@@......................................................++++++++++++++....................................................@@@@@@@@@@@@@@@@@@@@@@@@@@..........................................................................................0...................................................@@@@@@@@@@@@@@@@@....................................@@@@-------------@@@@...............................................................................@@@@.............................@@@@@@@@@@@@.................@@@@@@..............................................................................................................XXXXX@@@====.....................====@@XXXXXXXXX.........XXX.......@@............@@@@@@@@@@@@.............@@@@@@............................###=====.........................................................................................@@@.................................................
..................I.................................@@@@@@.....@@@@@@@@......@@@@@@.....@@@@..............@@@@@@@@@@@@.........................................+++++++++++##############++++++++++++++....................................@@@@@@@@@@@@@@@@@@@@@@@@@@@@@@........................................................................................0.................................................@@@@@@@@@@@@@@@@@@@@@..................................@@@@.............@@@@@@............................................................................@@@@@.............................@@@@@@@@@@@@.................@@@@@@@@....................................................................................XXXX.................XXXXXXXX@@@@@@@@@@@@@@@@@....@@@@@@@@@@@@@XXXXXXXXXXXXX...XXXXX.......@@............@@@@@@@@@@@@.............@@@@@@@@.........................+##=========.........................=======..................................======...............@@..............=====................++............
...@@............@@@@@@@@@@@@.......................@@@@@@.....@@@@@@@@......@@@@@@.....@@@@............@@@@@@@@@@@@@@@@...........................++++++++++++#######################################++++++++++++......................@@@@@@@@@@@@@@@@@@@@@@@@@@@@@@@@@@......................................................................................0......................+++++++++++++............@@@@@@@@@@@@@@@@@@@@@@@@@................................@@@@.............@@@@@@@@.........................................................................@@@@@@.............................@@@@@@@@@@@@.................@@@@@@@@@@...............................................................................XXXXXXXXX........XXXXXXXXXXXXXXX@@@@@@@@@@@@@@@@@....@@@@@@@@@@@@@XXXXXXXXXXXXXXXXXXXXXX......@@............@@@@@@@@@@@@.............@@@@@@@@@@.....................++###============................====================.....................================...@@@@@@@@@@.......=================.........####+...........
+++@@------------@@@@@@@@@@@@+++++++++++++++++++++++@@@@@@+++++@@@@@@@@++++++@@@@@@+++++@@@@++++++++++++@@@@@@@@@@@@@@@@+++++++++++++++++++++++++++###############################################################++++++++++++++++@@@@@@@@@@@@@@@@@@@@@@@@@@@@@@@@@@@@@@@@@@@@@@@@@@@@@@@@@@@@@@@@@@@@@@@@@@@@@@@@@@@@@@@@@@@@@@@@@@@@@@@@@@@@@@@@@@@@@@@@@@@@@@@@@@@@@@@@@++++++++++++#############++++++++++@@@@@@@@@@@@@@@@@@@@@@@@@@@@@@@@@@@@@@@@@@@@@@@@@@@@.......@@@@.............@@@@@@@@@@@@@@@@@@@@@@@@@@@@@@@@@@@@@@@@@@@@@@@@@@@@@@@@@@@@@@@@@@@@@@@@@@@@@@@@@@@@@@@.............................@@@@@@@@@@@@.................@@@@@@@@@@@@@@@@@@@@@@@@@@@@@@@@@@@@@@@@@@@@@@@@@@@@@@@@@@@@@@@@@@@@@@@@@@@@@@@@@@@@@XXXXXXXXXXXXXXXXX..XXXXXXXXXXXXXXXXXXXXXXXXXXXXXXXXXX....XXXXXXXXXXXXXXXXXXXXXXXXXXXXXXXXXXX......@@............@@@@@@@@@@@@.............@@@@@@@@@@+++++++++++++++++++++####===========================================================.....=========================@@@@@@@@@@================================######+++++++++++

0 I visible,door
k K visible,collectable
1 | visible,door
l L visible,collectable
2 I visible,door
m M visible,collectable
3 . door
n N visible,collectable
4 . undefined
5 . undefined
a - visible
b @ visible
c | undefined
d I undefined
e @ undefined
f . undefined
g . undefined
h . undefined
i . undefined
j . undefined
o . visible
p . visible
q . visible
r A visible,collectable
s . visible
t . visible
u . visible
v . visible
w C visible,treasure,collectable
x D visible,treasure,collectable
y E visible,treasure,collectable
z F visible,treasure,collectable
