...........................................................................................................................................................................................................................................................................................@@..@@..@@..................................................................................................@@..@@..@@........................................@@@@@@@@@@@@@@@@@@@@.......@@@@@@@@@@@@.....@@@@@@.....................
...........................................................................................................................................................................................................................................................................................@@@@@@@@@@..................................................................................................@@@@@@@@@@...........................................@@...........@@@.........@@@.......@.........@@.....................
...........................................................................................................................................................................................................................................................................................@@@@@@@@@@..................................................................................................@@@@@@@@@@...........................................@@............|...........|........@@........@@.....................
...........................................................................................................................................................................................................................................................................................@@@@@@@@@@..................................................................................................@@@]..[@@@....................................@@@....@@............|...........|..................@@.....................
.............................................................................@@..@@....................................................................................................................................................................................................................................................................................................................@@@@@@@@@@...........................................@@............|...........|..................@@.....................
.............................................................................@@@@@@....................................................................................................................................................................................................................................................................................................................@@@@@@@@@@...........................................@@............|...........|..................@@.....................
................@@..@@..@@..@@...............................................@]..[@.........................................................................................@@@@..................................................................................................................................................................................................................................................................@@@.......@@..@@@@@@@@@@@@.........@@@@@@@@@@@@...@@@@@@@.....................
................@@@@@@@@@@@@@@...............................................@@@@@@...........................................................................................@@.........................................................................................................@@@@@@@@@@@@@@.....................................................................................................................................................@@..@@........|...........|.........................................
.................@@@@@@@@@@@@................................................@@@@@@...........................................................................................@@.........................................................................................................@@@/\@@@@/\@@@..................................................................................@@@@@@.............................................................@@..@@........|...........|.........................................
.................@@@..........................................................................................................................................................@@.........................................................................................................@@]..[@@]..[@@........................................................................................................................................@@@..........@@..@@........|...........|.........................................
..................I........................................................................................................................................@@@@@@@@@@@@@@@....@@.........................................................................................................@@]..[@@]..[@@.............................................+++++++..........++++++++++++]------aaaaaaaa------[@@@@@@@@@@@+.........................................@@..@@........|...........|.........................................
..................I...........................................................................................................................................................@@...................................@@@@@@-----------@@@@@@.............................................@@@@@@@@@@@@@@@@@@.............................++++++++++++++#######++++++++++############@....................@@@@@@@@@@@@#+........................................@@..@@@@@@@@@@@@@@@@@@@@@@@@@@@@@@@@.....@@@@@@@@@@@@...............
..................I.........................................................@@@@@@@@..........................................................................................@@.................................@@@@...................@@@@........................................................................................@@###########################################@....................@@@@@/\@@@@@##++......................@@@.............@@..................................................................
..................I...............@@..@@..@@..@@..@@......................@@@@@@@@@@@@..........................+++++++++++++++...............................................@@@@.............................@@@@.......................@@@@....................................................................................@@@@###########################################@....................@@@@]..[@@@@####++....................................@@..................................................................
.................@@@@@@@@@@@@.....@@@@@@@@@@@@@@@@@@....................@@@@@@@@@@@@@@@@................++++++++###############++++++++++...................................@@@@@@@@......+++................@@@@...........................@@@@................................................................................@@@@@@###########################################@....................@@@@]..[@@@@######+++++...............................@@..................................................................
+++@@------------@@@@@@@@@@@@+++++++++++++++++++++++++++++++++++++++++++@@@@@@@@@@@@@@@@++++++++++++++++#################################+++++++++@@@@@@@@@@@@@@@@@@@@@@@@@@@@@@@@@@@@@@@@###++++++++++++++++@@@@...........................@@@@++++++++++++++++++++++++++++++++++++@@@@@@@@@@@@@@@@@@@@@@++++++++++++++++++++@@@@@@@@###########################################@....................@@@@@@@@@@@@###########++++++++++++++.................@@@@@@@@@@@@@@@@@@@@@@@@@@@@@@@@@@@@@...@@@@@@@@@@@@@@@@@@@@@@@@@@@@

a - 1 0
b @ 2 1
