...........................................................................................................................................................................................................................................................................................@@..@@..@@..................................................................................................@@..@@..@@..........................................................................................................................................@@..@@..@@..@@..@@..@@..@@..@@..@@..@@...........................................@@..@@..@@..@@..@@..@@......@@..@@
...........................................................................................................................................................................................................................................................................................@@@@@@@@@@..................................................................................................@@@@@@@@@@.....................................................................@@@@@@@@@@@@@@@@@@@@@.....@@@@@@@@@@@@@@@......@@@@@@................@@@@@@@@@@@@@@@@@@@@@@@@@@@@@@@@@@@@@@...........................................@@@@@@@@@@@@@@@@@@@@@@......@@@@@@
...........................................................................................................................................................................................................................................................................................@@@@@@@@@@..................................................................................................@@@@@@@@@@.....................................................................@@...............@@@.......@@@.......................................@@@@@@@@@@@@@@@@@@@@@@@@@@@@@@@@@@@@@@...........................................@@@@@@@@@@@@@@@@@@@@@@......@@@@@@
...........................................................................................................................................................................................................................................................................................@@@@@@@@@@..................................................................................................@@@]..[@@@..............................................................@@@@...@@................c.........c......................................@@@@@@@@@@@@@@@@@@@@@@@@@@@@@@@@@@@@@@@@...........................................@@@.........................@@@@@@
.............................................................................@@..@@....................................................................................................................................................................................................................................................................................................................@@@@@@@@@@.....................................................................@@................c.........c....................................@@@@@@/\@@@@@@/\@@@@@@/\@@@@@@/\@@@@@@/\@@...........................................@@@.......................@@@@@@@@
.............................................................................@@@@@@....................................................................................................................................................................................................................................................................................................................@@@@@@@@@@.....................................................................@@................c.........c..................................@@@@@@@]..[@@@@]..[@@@@]..[@@@@]..[@@@@]..[@...........................................@@@...............................
................@@..@@..@@..@@...............................................@]..[@.......................................................................................................................................................................................................................................................................................................................................................................................@@@@........@@..@@@@@@@@@@@@@@@@.......@@@@@@@@@@@@@@@@...@@@@@@@....@@@@@@@@@@@@@]..[@@@@]..[@@@@]..[@@@@]..[@@@@]..[@............................................d................................
................@@@@@@@@@@@@@@...............................................@@@@@@...........................................................................@@@@@@@@.....@@@@..........................................................................................................@@@@@@@@@@@@@@...............................................................................................................................................................................@@..@@...........@@@--...--@@@.....................@@....@@@@@@@@@@@@@]..[@@@@]..[@@@@]..[@@@@]..[@@@@]..[@............................................d.............@@----@@...........
.................@@@@@@@@@@@@................................................@@@@@@..........................................................................................@@..........................................................................................................@@@/\@@@@/\@@@..................................................................................@@@@@@.......................................................................................@@..@@............c.........c......................@@....@@@@@@@@@@@@@@@@@@@@@@@@@@@@@@@@@@@@@@@@@@@@@@@@@@............................................d................................
.................@@@.........................................................................................................................................................@@..........................................................................................................@@]..[@@]..[@@..............................................................................................................................................................@@@@.............@@..@@............c.........c......................@@....@@@@@@@@@@@@@@@@@@@@@@@@@@@@@@@@@@@@@@@@@@@@@@@@@@............................................d..............................@@
..................I..........................................................................................................................................................@@..........................................................................................................@@]..[@@]..[@@.............................................+++++++..........++++++++++++]------aaaaaaaa------[@@@@@@@@@@@+...................................................................@@..@@............c.........c......................@@....@@@@@@@@@@@@@@@@@@@@@@@@@@@@@@@@@@@@@@@@@@@@@@@@@@...............XXXX........................@@@@@@@@@@@.....................@@
..................I........................................................................................................................................@@@@@@@@@@@@@@@...@@....................................@@@@@@-----------@@@@@@.............................................@@@@@@@@@@@@@@@@@@.............................++++++++++++++#######++++++++++############@....................@@@@@@@@@@@@#+..........................................++++....................@@..@@@@@@@@@@@@@@@@@@@@@@@@@@@@@@@@@@@@@@.....@@@@@@....@@@@@@@@@@@@@@@@@@@@@@@@@@@@@@@@@@@@@@@@@@@@@@@@@@.............XXXXXXXXX..................XXX@@@@@@@@@@@@@...................@@
..................I.........................................................@@@@@@@@.........................................................................................@@..................................@@@@...................@@@@........................................................................................@@###########################################@....................@@@@@/\@@@@@##++........................................####....................@@.....................................................................................................................XXXXXXXXXX......XX........XXXXXXXXXXXXXXXX@@@@..........@@@@...@@
..................I.......................................................@@@@@@@@@@@@..........................+++++++++++++++..............................................@@@@..............................@@@@.......................@@@@....................................................................................@@@@###########################################@....................@@@@]..[@@@@####++...............................++++...####....................@@...................................................................................................................XXXXXXXXXXXXX....XXXX......XXXXXXXXXXXXXXXXXXX@@@@....@@@@@XX@@@@@@
.................@@@@@@@@@@@@...........................................@@@@@@@@@@@@@@@@................++++++++###############++++++++++..............@@....................@@@@@@.......+++................@@@@...........................@@@@................................................................................@@@@@@###########################################@....................@@@@]..[@@@@######+++++..........................####...####....................@@..................................................................................................................XXXXXXXXXXXXXX....XXXXX.....XXXXXXXXXXXXXXXXXXXXXXX....XXXXXXXXXXXXX
+++@@------------@@@@@@@@@@@@+++++++++++++++++++++++++++++++++++++++++++@@@@@@@@@@@@@@@@++++++++++++++++#################################+++++++++@@@@@@@@@@@@@@@@@@@@@@@@@@@@@@@@@@@@@@@@###++++++++++++++++@@@@...........................@@@@++++++++++++++++++++++++++++++++++++@@@@@@@@@@@@@@@@@@@@@@++++++++++++++++++++@@@@@@@@###########################################@....................@@@@@@@@@@@@###########++++++++++++++++++++++....####...####....................@@@@@@@@@@@@@@@@@@@@@@@@@@@@@@@@@@@@@@@@@@@...@@@@@@@@@@@@@@@@@@@@@@@@@@@@@@@@@@@@@@@@@@@@@@@@@@@@@@@@@@@@@@@.....XXXXXXXXXXXXXXXX...XXXXXXX....XXXXXXXXXXXXXXXXXXXXXXX....XXXXXXXXXXXXX

a - 1 0
c | 3 0
b @ 2 1
d I 4 0
