...........................................................................................................................................................-------@@@@..................................................................................................@@..@@..@@....................................................@@.....@@@@@@@@@@@@@@@@@@@@@@@@@@@@@@@@@@@@@.....@@@@@@@@@@@@@@@@@@@@@@@@@@@@@@@@@@@@@@@@@.............??.......................................@@@@@@@@@@@@..................@@....@@....@@..@@....@@..@@....@@....@@....@@....@@..@@....@@....@@....@@....@@........................................@@..@@..@@..@@..@@..@@..@@..@@..@@...................................................................
.......................................................................................................................................................k.............@@.................................................................................................@@@@@@@@@@....................................................@@........................................@@............................................@@@............@@.......................................@@@@@@@@@@@@..................@@@@@@@@@@@@@@..@@@@@@@@..@@@@@@@@@@@@@@@@@@@@@@@@@@..@@@@@@@@@@@@@@@@@@@@@@@@@@........................................@@@@@@@@@@@@@@@@@@@@@@@@@@@@@@@@@@...................................................................
......................................................................................................................................................................@@................................................................................................@@@@@@@@@@....................................................@@........................................@@............................................@@@@...........@@.......................................@@@.@@@@.@@@------------------@@@@@@@@@@@@@@..@@@@@@@@..@@@@@@@@@@@@@@@@@@@@@@@@@@..@@@@@@@@@@@@@@@@@@@@@@@@@@........................................@@@@@@@@@@@@@@@@@@@@@@@@@@@@@@@@@@...................................................................
......................................................................................................................................................@@@@@............@@@@@@@@@@@@@@@@@@@@@@@@@@@@@@@@@@@@@@@@@@@@@@------------@@@@@@@@@@@@...........................@@@@/\@@@@....................................................@@........................................@@............................................@@@@@..........@@.......................................@@@.@@@@.@@@...................1............................................................................@@........................................@@@.............................@@...................................................................
.............................................................................@@..@@.....................................................................@@@.............................................................................................................@@@]..[@@@....................................................@@@@@@@...................................@@@@@@@.......................................@@@@@@.........@@..........................@@-----------@@@@@@@@@@@@...................1......................................................l.....................@@........................................@@@.............................@@........--------@@@@........@@@@....@@@@@@@@.......................
.............................................................................@@@@@@......................................................................@@.............................................................................................................@@@]..[@@@....................................................@@@@@@@@@@@@@@@@@@@@@@@@@@@@@@@@@@@@.....@@@@@@@@@@@@@@@@@@@@@@@@@@@@@@@@@@.............@@@@@@@........@@.........................@@@...........@@@@@@@@@@@@...................1............................................................................@@........................................@@@.................................................@@........@@............@@.......................
................@@..@@..@@..@@...............................................@]..[@.......................................................................@@............................................................................................................@@@@@@@@@@....................................................................................................................@@..............@@@@@@@@@@@@@@@@@@@@@@@@@.....................................................................@@@@@@@@@@@@@@@@@@@@..@@@@@@@@@@@@..@@@@@@@@@@@@@@@....@@@@@@@@@@@@@@@@.......@@.........................................d..................................................@@@@....@@@@............@@@@.....................
................@@@@@@@@@@@@@@...............................................@@@@@@........................................................................@@@@@@@@@@@@@@@@@@@@@@@@@@@@@................@@@@@@@@@@@@@@..........@@@@@@@@@@@@@---------------------------@@@@@@@@@@....................................................................................................................@@.....................................@@.............................................................................@@@@@@@@@@@@..@@@@@@@@@@@@..@@@@@@@@@@@@@@@....@@@@@@@@@@@@@@@@@@.....@@.........................................d.............@@----@@.............................@@......................@@@@.....................
.................@@@@@@@@@@@@................................................@@@@@@....................................................................................................@@..............@@...............................................................@@@@@@@@@@....................................................................................................................@@.....................................@@.............................................................................@@@@@@@@@@@@..@@@@@@@@@@@@............................................@@.........................................d..................................................@@......................@@@@@@...................
.................@@@....................................................................................................................................................................@@............@@................................................................@@@@@@@@@@........................................................................................@@@@@.......................@@.....................................@@......................@@.....................................................@@@@@@@@@@@@..@@@@@@@@@@@@..........................................@@@@.........................................d..............................@@..................XX......................@@@@@@...................
..................I......................................................................................................................................................................@@..........@@.................................................................@@@@@@@@@@......................................................@@@@@@@@@@@.....@@@@@@@@@@@@@@@@@@@@@@@@@]--------------------@@.........@@@@@.......................@@........@@------------@@@@@@-----------@@@@@@@@@@@@------------------@@@@@...@@@@@@@@@@@@..@@@@@@@@@@@@.........................................@@@@@........................................@@@.............................@@XXX...............XX................----@@@@@@@@@@@@@@....@@@@@@@@@
..................I...................................................................................................................................@@@@@@@@@@@@@@@@@@@@@@@@@@@@@@......@@@@@@@@@@@@......@@@@@@@@@@@@@@@@@@@@@@@@@@@@@@..............................@@@@@@@@@@....................................................@@@@...................................................................@@@@@@@@@@@@@@@@@@@@@@@@@@@@@@@@@@.......@@@............@@@@@@...........@@@@@@@@@@@@..................@@@@@...@@@@@@@@@@@@..@@@@@@@@@@@@@@@@@@@@@@@@@@@@@@..@@@@@@@@@@@@@@@@@@@@@@@@@@.....................................XXX@@@...........................==@@XXXXXX............XXX.....................@@@@@@@@@@@@----@@.......
..................I.........................................................@@@@@@@@...............................................................................................@@......................@@@@@@@@@@@@@@@@@@@@@@@@@@@@@@@@..............................0...............................++++++++...................@@@@@@...........................................................................................................@@@@............@@@@@@...........@@@@@/\@@@@@..................@@@@@..............................................................................................................XXXXX@@@====.....................====@@XXXXXXX...........XXX.....................@@@@@@@@@@@@....@@.......
..................I.......................................................@@@@@@@@@@@@..........................+++++++++++++++.....................................................@@....................@@@@@@@@@@@@@@@@@@@@@@@@@@@@@@@@@@.............................0..........................+++++########+++++............@@@@@@@@..........................................................................................................@@@@@............@@@@@@...........@@@@]..[@@@@..................@@@@@......................................................................................XXXX...................XXXXXX@@@@@@@@@@@@@@@@@....@@@@@@@@@@@@@XXXXXXX.........XXXXX.......X............XX@@@@@..@@@@....@@.......
.................@@@@@@@@@@@@...........................................@@@@@@@@@@@@@@@@................++++++++###############++++++++++............................................@@..................@@@@@@@@@@@@@@@@@@@@@@@@@@@@@@@@@@@@............................0....................++++++##################++++++....@@@@@@@@@@.........@@@@@...........................................................................................@@@@@@............@@@@@@...........@@@@]..[@@@@..................@@@@@...................................................................................XXXXXXXXX........XXXX...XXXXXXXX@@@@@@@@@@@@@@@@@....XXXXXXXXXXXXXXXXXXXXX........XXXXXX......XX...........XXXX@@@..@@@@....@@.......
+++@@------------@@@@@@@@@@@@+++++++++++++++++++++++++++++++++++++++++++@@@@@@@@@@@@@@@@++++++++++++++++#################################+++++++++@@@@@@@@@@@@@@@@@@@@@@@@@@@@@@@@@@@@@@@@@@@@@@@@@@@@@@@@@@@@@@@@@@@@@@@@@@@@@@@@@@@@@@@@@@@@@@@@@@@@@@@@@@@@@@@@@@@@@@@@@@@@@@@@@@++++++++++##############################++@@@@@@@@@@@@@@@@@@@@@@@@@@@@@@@@@@@@@@@@@@@@@@@@@@@@....................@@@@@@@@@@@@@@@@@@@@@@@@@@@@@@@@@@@@@@@@@@@@@@@@@@@............@@@@@@...........@@@@@@@@@@@@..................@@@@@@@@@@@@@@@@@@@@@@@@@@@@@@@@@@@@@@@@@@@@@@@@@@@@@@@@@@@@@@@@@@@@@@@@@@@@@@@@@@@@XXXXXXXXXXXXXXXXX..XXXXXXXXXXXXXXXXXXXXXXXXXXXXXXXXXX....XXXXXXXXXXXXXXXXXXXXX.......XXXXXXX.....XXXX.........XXXXX@@@@@@@@@....@@.......

0 I 1
1 | 1
2 . 0
3 . 0
4 . 0
5 . 0
a - 1
b @ 1
c | 0
d I 0
e @ 0
f . 0
g . 0
h . 0
i . 0
j . 0
k K 1
l L 1
m K 1
n L 1
o K 1
p L 1
q K 1
r L 1
s K 1
t L 1
u K 1
v L 1
w K 1
x L 1
y K 1
z L 1
