........................................................................................................................................................................................................................................@@.......@@.............@@.........................@@..................................................................@@..@@..@@..............................................?...?...................................................................................................?...?......................................................................................................................................@......@..................................................................................@@..@@..@@....................................................................@@..@@..@@.........................................................................................++++++++++++++....++++++++......................++++++++++++.................................................................................................@@.@@.@@............................................................................................................@@@@@@@@@@@@@@@@@@@@@@---------------------------------------------------@@.....@@@@@@@@@@@@.............................................................
........................................................................................................................................................................................................................................@@.k...@@@@@@.........@@@@@@.......................@@..................................................................@@@@@@@@@@.............................................@@...@@.................................................................................................@@...@@.....................................................................................................................................@@.@@.@@..................................................................................@@@@@@@@@@................................@@..@@..@@..........................@@@@@@@@@@......................................................................................+++##############++++########++++++++++++++++++++++############++........................................+++++++++..............................................@@@@@@@@..........................................................................................................@@@@@@@@@@@@@@@@@@@@@@@@..........................................................@@@@@@@@@@@@.............................................................
........................................................................................................................................................................................................................................@@...@@@@@@@@@@@@@@@@@@@@@@@@@@@@@@@@@@@@@.........@@..................................................................@@@@@@@@@@.............................................@@@@@@@@@@@@@@@@@@@@@@@@@@@@@@@@@@@@@@@@@@@@@@@@@@@@@@@@@@@@@@@@@@@@@@@@@@@@@@@@@@@@@@@@@@@@@@@@@@@@@@@@@@@@@@@.....................................................................................................................................@@@@@@@@..................................................................................@@@@@@@@@@................................@@@@@@@@@@..........................@@@@@@@@@@.....................................................................................+##########=======#####======########################==========###+++++.............................++++++#########++++++........................................bb....bb........................................................................................................@@@@@@@@@@@@@@@@@@@@@@@@@@..........................................................@@@@@@@@@@@@.............................................................
..............................................................................................................?.........................................................................................................................@@@@@@@@@@@@@@@@@@@@@@@@@@@@@@@@@@@@@@@@@@@@.......@@..................................................................@@@@/\@@@@.............................................@@@@@@@.................................................................................................@@@@@@@.....................................................................................................................................2......2..................................................................................@@..@@..@@................................@@@@@@@@@@..........................@@..@@..@@.....................................................................................#########===.....=======================#####====================######+++++++++............++++++++#######=======#######++++++..................+++++++.........bb.m..bb.........................................................................................@@@@@@@@@@@@@@@@@@@@@@@@@@@@@@@@@@@@@@@@@..........................................................@@@@@@@@@@@@.............................................................
.............................................................................................................@@..@@.....................................................................................................................@@@@@@@@@@@@@@@@@@@@@@@@@@@@@@@@@@@@@@@@@@@@.......@@..................................................................@@@@..@@@@.............................................@@@@@@@.................................................................................................@@@@@@@.....................................................................................................................................2......2..................................................................................@@@@@@@@@@....................................................................@@@@@@@@@@....................................................................................+######=====.........{........==========================....{.....=====##########++++++++++++#########===================#######++++.........+++++#######+++++....bb....bb.........................................................................................@@@@@@@@@@@@@@@@@@@@@@@@@@@@@@@@@@@@@@@@@.....................@@...............................@@@@@@@@@@@@@@@@.........................................@@@@@@@@............
.............................................................................................................@@@@@@........................................................................................................................................................................@@..................................................................@@@@..@@@@.............................................@@@@@@@.................................................................................................@@@@@@@.....................................................................................................................................2..wx..2..................................................................................@@@@@@@@@@....................................................................@@@@@@@@@@....................................................................................####====...{....................{........======.....{................===========##############=================================#####+++++++++#################++++@@@@@@@@.........................................................................................@@@@@@@@@@@@@@@@@@@@@@@@@@@@@@@@@@@@....c.............................................@@.......@@@@@@@@@@@@@@@@.........................................@@@@@@@@............
................@@..@@..@@..@@...............................................................................@@@@@@......................................................................................................................................................................@@@@..................................................................@@@@@@@@@@.................................................................................................................................................................................................................................................................................................2......2...................................................................................1............................................................................@@......@@......................................................................................#===.......................................{...........................=================================..{.....{.===============###########=========###################.........................................................................................@@@@@@@@@@@@@@@@@@@@@@@@@@@@@@@@@@@@....c..........@@@......................@@.................@@@@@@@@@@@@@@@@@@@@@@@@@@@@@@@@@@@@@@@@@@@@@@@@@@.......@@@/\@@@............
................@@@@@@@@@@@@@@...............................................................................@@@@@@....................................................................................................................................................................@@......................................................................@@@@@@@@@@...........................................................@@@@@@@@@@@@@@@@@@@@@@@@@@@@@@@@@@@@@@@@@@@@@@@@@@@@@@@@@@@@@@@@@@@@@@@@@@@@@@@@@@.......................................................................................................................................@@@@@@......@@@@@@@@@@......@@@@@@......................................................................1......................................................................................................................................................................................................................................................{....===============.......{..................{....{..==============........##########.............................................................................................@@@@@@@@@@@@@@@@@@@@@@@@@@@@@@@@@@@@@@@@....c...........................@@@@..........@@...........@@@@@@@@@@@@@@@@@@@@@@@@@@@@@@@@@@@@@@@@@@@@@@@@@@.......@@@..@@@............
.................@@@@@@@@@@@@................................................................................@@@@@@.........................................................@@@@@@@@@@.........................................................................................................................................................................@@@@@@@@@@........................................................................................................................................................................................................................................................................@@@@@@........@@..........@@@@@@..........@@........@@@@@@..........................................................1.................................................................................................................................................................................................................................................................=======.................................................................................................................................................................@@@@@@@@@@@@@@@@@@@@@@@@@@@@@@@@@@@@@@@@.yz.c................@@................................@@@@@@@@@@@@@@@@@@@@@@@@@@@@@@@@@@@@@@@@@@@@@@@@@@@@@@@@@@@@@@@@..@@@............
.................@@@........................................................................................................................................................@@@@/\@@@@.........................................................................................................................................................................@@@@@@@@@@.................................................................................................l........................................................................................................................................................................@@..................................................@@........@@@@@@..............................................1........................................@@@@@@@@@@.................................................................................................................................................................................................................{...................................................................................+++++.............................................................................@@@@@@@@@@@@@@@@@@@@@@@@@@@@@@@@@@@@@@@@@@@@@@.................................................@@@@@@@@@@@@@@@@@@@@@@@@@@@@@@@@@@@@@@@@@@@@@@@@@@@@@@@@@@@@@@@@@@@@@............
..................I.........................................................................................................................................................@@@@..@@@@.........................................................................................................................................................................@@@@@@@@@@..........................................................................................................................................................................................................@@-------------------@@@@@@@@...................................................................................................@@...............................................@@@@@@@@@@..............................@@@@@@@@@@@@..........................@@@@@@@@@@-----------------------------@@....................................................====.......................................................................................................................................................................+++#####++++.........................................................................@@@@@@@@@@@@@@@@@@@@@@@@@@@@@@@@@@@@@@@@@@@@@....@@@@..............@@..........................@@@@@@@@@@@@@@@@@@@@@@@@@@@@@@@@@@@@@@@@@@@@@@@@@@@@@@@@@@@@@@@@@@@@@............
..................I................................................@@@@.....................................................................................................@@@@..@@@@..................................................@@@@@@@@@@@@@@@@@@@@@@@@@@@@@@@@@@@@@@@@@@@@@@@........................................................................@@@@@@@@@@.....................................................@@@@@@.................@@@@................@@@@.............@@@@.....................@@@@@@@@@@....................................................@@@@...................@@@@@@@@@@...............................................................................................................................................XXXXXX@@@@@@@......................XXXXXXXX@@@@@@@@@@@@.................XXXXXXXXXXXXXXXXXXX.............................##@@................................................=======.................................................................................................................................................................+++++############++++++...............................................................@@@@@@@@@@@@@@@@@@@@@@@@@@@@@@@@@@@@@@@@@@@@@@@@@..................................................@@@@@@@@@@@@@@@@@@@@@@@@@@@@@@@@@@@@@@@@@@@@@@@@@@@@@@@@@@@@@@@@/\@@@............
..................I................................................@@@@.................@@@@................@@@@@@@@....................................................+++++++++++++++++.............................................@@@@@@@@@@@@@@@@@@@@@@@@@@@@@@@@@@@@@@@@@@@@@@@@@@@.......................................................................0...........................................................@@@@@@@@@@...................................@@@@-------------@@@@@@...............................................................................@@@@@@...................@@@/\@@@@@@@....................@@@@@@..............................................................................@@@@@@.............................XXXXXXXXXX@@@@@...................XXXXXXXXXXXXXX@@@@@@@@@..XXXXXXXXXXXXXXXXXXXXXXXXXXXXXXXXXXX............................####@@.............................................==========...........................................................................................................................................................###########################+++++++........................................................@@@@@@@@@@@@@@@@@@@@@@@@@@@@@@@@@@@@@@@@@@@@@@@@@................................@@.........@@@@...@@@@@@@@@@@@@@@@@@@@@@@@@@@@@@@@@@@@@@@@@@@@@@@@@@@@@@@@@@@@@@@@..@@@............
..................I.................................@@@@@@.....@@@@@@@@......@@@@@@.....@@@@..............@@@@@@@@@@@@.........................................+++++++++#################+++++++++++++..............................@@@@@@@@@@@@@@@@@@@@@@@@@@@@@@@@@@@@@@@@@@@@@@@@@@@@@@@.....................................................................0.........................................................@@@@@@@@@@@@@@.................................@@@@.............@@@@@@@@...........................................................................@@@@@@@@...................@@@..@@@@@@@@@....................@@................................@@@@..............................................@@............................XXXXXXXXXXXXXXX@@@.................XXXXXXXXXXXXXXXXXXXX@@@@@XXXXXXXXXXXXXXXXXXXXXXXXXXXXXXXXXXXXX...........................#######@@...........................................=============.........................=======..................................======...............................=====................==....................########################################++++++..................................................@@@@@@@@@@@@@@@@@@@@@@@@@@@@@@@@@@@@@@@@@@@@@@@@@...............@@@@@..............................@@@@@@@@@@@@@@@@@@@@@@@@@@@@@@@@@@@@@@@@@@@@@@@@@@@@@@@@@@@@@@@@..@@@............
...@@............@@@@@@@@@@@@.......................@@@@@@.....@@@@@@@@......@@@@@@.....@@@@............@@@@@@@@@@@@@@@@...........................++++++++++++#######################################++++++++++++................@@@@@@@@@@@@@@@@@@@@@@@@@@@@@@@@@@@@@@@@@@@@@@@@@@@@@@@@@@@...................................................................0......................+++++++++++++....................@@@@@@@@@@@@@@@@@@...............................@@@@.............@@@@@@@@@@.......................................................................@@@@@@@@@@...................@@@..@@@@@@@@@@@.................@@@@.....@@@@........@@@@........@@@@@@@@........@@@@........@@@@........@@@@........@@.....................XXXXXXXXXXXXXXXXXXXXXXXXXXXXXXXX......XXXXXXXXXXXXXXXXXXXXXXXXXXXXXXXXXXXXXXXXXXXXXXXXXXXXXXXXXXXXXXXXXX...........................#########@@.......................................==================................====================.....................================......====..........=================.........======........########################################################+++++.............................................@@@@@@@@@@@@@@@@@@@@@@@@@@@@@@@@@@@@@@@@@@@@@@@@@..................................................@@@@@@@@@@@@@@@@@@@@@@@@@@@@@@@@@@@@@@@@@@@@@@@@@@@@@@@@@@@@@@@@@@@@@@@@@@@@@@@@@
+++@@------------@@@@@@@@@@@@+++++++++++++++++++++++@@@@@@+++++@@@@@@@@++++++@@@@@@+++++@@@@++++++++++++@@@@@@@@@@@@@@@@+++++++++++++++++++++++++++###############################################################++++++++++++++++@@@@@@@@@@@@@@@@@@@@@@@@@@@@@@@@@@@@@@@@@@@@@@@@@@@@@@@@@@@@@@@@@@@@@@@@@@@@@@@@@@@@@@@@@@@@@@@@@@@@@@@@@@@@@@@@@@@@@@@@@@@@@@@@@@@@@@@@@++++++++++++#############++++++++++++++++++@@@@@@@@@@@@@@@@@@@@@@@@@@@@@@......@@@@@@@@@@.....@@@@.............@@@@@@@@@@@@@@@@@@@@@@@@@@@@@@@@@@@@@@@@@@@@@@@@@@@@@@@@@@@@@@@@@@@@@@@@@@@@@@@@@@@@@@@@@@@...................@@@@@@@@@@@@@@@@@@@@@@@@@@@@@@@@@@@@@@@@@@@@@@@@@@@@@@@@@@@@@@@@@@@@@@@@@@@@@@@@@@@@@@@@@@@@@@@@@@@@@@@@@@@@@@@XXXXXXXXXXXXXXXXXXXXXXXXXXXXXXXXXXXXXXXXXXXXXXXXXXXXXXXXXXXXXXXXXXXXXXXXXXXXXXXXXXXXXXXXXXXXXXXXXXXXXXXXXXXXXXXXXXXXXXXXXXXXXXXXXXXXXXX.........................############+++++++++++++++++++++++++++++++++++++==================================================================.....======================================================================================#########################################################+++++++++++++++++++++++++++++++++++++++++++++@@@@@@@@@@@@@@@@@@@@@@@@@@@@@@@@@@@@@@@@@@@@@@@@@.........@@@.............@@@@.........@@@.........@@@@@@@@@@@@@@@@@@@@@@@@@@@@@@@@@@@@@@@@@@@@@@@@@@@@@@@@@@@@@@@@@@@@@@@@@@@@@@@@@

0 I visible,door
k K visible,collectable
1 | visible,door
l L visible,collectable
2 I visible,door
m M visible,collectable
3 . door
n N visible,collectable
4 . undefined
5 . undefined
a - visible
b @ visible
c | visible,door
d I undefined
e @ undefined
f . undefined
g . undefined
h . undefined
i . undefined
j . undefined
o . visible
p . visible
q . visible
r A visible,collectable
s . visible
t . visible
u . visible
v . visible
w C visible,treasure,collectable
x D visible,treasure,collectable
y E visible,treasure,collectable
z F visible,treasure,collectable
