........................................................................................................................................................................................................................................@@.......@@.............@@.........................@@..................................................................@@..@@..@@..............................................?...?...................................................................................................?...?.................................................................................................................................@@..@@..@@....................................................................@@..@@..@@.....................................................................................r...++++++++++++++++++++++++++......................++++++++++++.........................................................................................................................................................................................+++++++++++........+++++++......................++++++++++++...............................................................................................@@@@@@@@@@@@@@@@@@@@@@@@@@@@@@@@@@@--------------------------------------------------@@@@....@@@@@@@@@@@@@@@@@@@@@@@@@@@@@@@@@@@@@@@@@@@@@@@@@@@@@@@@@@@@@@@@@@@@@@@@.......................................................................................@......@..............................................................................................@@.@.@@.................................................................................................................................................@@.@@.@@................................................
........................................................................................................................................................................................................................................@@.k...@@@@@@.........@@@@@@.......................@@..................................................................@@@@@@@@@@.............................................@@...@@.................................................................................................@@...@@................................................................................................................................@@@@@@@@@@................................@@..@@..@@..........................@@@@@@@@@@......................................................................................+++##########################++++++++++++++++++++++############++........................................+++++++++...................................................................................................................................+++###########++++++++#######+++++++.......++++++++############+++++..........................................................................................@@@@@@@@@@@@@@@@@@@@@@@@@@@@@@@@@@@..........................................................@@@@@@@@@@@@@@@@@@@@@@@@@@@@@@@@@@@@@@@@@@@@@@@@@@@@@@@@@@@@@@@@@@@@@@@@.......................................................................................@@.@@.@@..............................................................................................@@@@@@@...................@@@...........................................................................................................................@@@@@@@@................................................
........................................................................................................................................................................................................................................@@...@@@@@@@@@@@@@@@@@@@@@@@@@@@@@@@@@@@@@.........@@..................................................................@@@@@@@@@@.............................................@@@@@@@@@@@@@@@@@@@@@@@@@@@@@@@@@@@@@@@@@@@@@@@@@@@@@@@@@@@@@@@@@@@@@@@@@@@@@@@@@@@@@@@@@@@@@@@@@@@@@@@@@@@@@@@................................................................................................................................@@@@@@@@@@................................@@@@@@@@@@..........................@@@@@@@@@@.....................................................................................+##############==============########################==========###+++++.............................++++++#########++++++...........................................................................................................................++####################################+++++++#########################+++.......................................................................................@@@@@@@@@@@@@@@@@@@@@@@@@@@@@@@@@@@..........................................................@@@@@@@@@@@@@@@@@@@@@@@@@@@@@@@@@@@@@@@@@@@@@@@@@@@@@@@@@@@@@@@@@@@@@@@@.......................................................................................@@@@@@@@...............................................................................@@@.............@........@@@.....@@@...................................................................................................................................@@@@@@@@................................................
..............................................................................................................?.........................................................................................................................@@@@@@@@@@@@@@@@@@@@@@@@@@@@@@@@@@@@@@@@@@@@.......@@..................................................................@@@@/\@@@@.............................................@@@@@@@.................................................................................................@@@@@@@................................................................................................................................@@..@@..@@................................@@@@@@@@@@..........................@@..@@..@@.....................................................................................#########===============================#####====================######+++++++++............++++++++#######=======#######++++++..................+++++++..........................................................................................++#########################################################################++...............................................................................@@@@@@@@@@@@@@@@@@@@@@@@@@@@@@@@@@@@@@@@@..........................................................@@@@@@@@@@@@@@@@@@@@@@@@@@@@@@@@@@@@@@@@@@@@@@@@@@@@@@@@@@@@@@@@@@@@@@@@.......................................................................................2......2........................................................................@@@...........@@@......@...q..................................................................................................................................................@@@@@@@@................................................
.............................................................................................................@@..@@.....................................................................................................................@@@@@@@@@@@@@@@@@@@@@@@@@@@@@@@@@@@@@@@@@@@@.......@@..................................................................@@@@..@@@@.............................................@@@@@@@.................................................................................................@@@@@@@................................................................................................................................@@@@@@@@@@....................................................................@@@@@@@@@@....................................................................................+######=====.........{........==========================....{.....=====##########++++++++++++#########===================#######++++.........+++++#######++++++...................................................................................+#############################################################################+..............................................................................@@@@@@@@@@@@@@@@@@@@@@@@@@@@@@@@@@@@@@@@@.....................@@...............................@@@@@@@@@@@@@@@@@@@@@@@@@@@@@@@@@@@@@@@@@@@@@@@@@@@@@@@@@@@@@@@@@@@@@@@@@@@@.......................................................................................2......2...............................................................................................@.m.q...........................@@@@@@@@@@@@@@@@@@@@@@@@@@@@@@@@@@@@@@@@@@@@@@@@@@@@@@@@@@@@@@@@@@@@@@@@@@@@@@@@@@@@@@@@@@@@@@@@@@@....................@@@@@@@@................................................
.............................................................................................................@@@@@@........................................................................................................................................................................@@..................................................................@@@@..@@@@.............................................@@@@@@@.................................................................................................@@@@@@@................................................................................................................................@@@@@@@@@@....................................................................@@@@@@@@@@....................................................................................####====...{....................{........======.....{................===========##############=================================#####+++++++++##################.s...............................................................................++###############################################################################++............................................................................@@@@@@@@@@@@@@@@@@@@@@@@@@@@@@@@@@@@..................................................@@.......@@@@@@@@@@@@@@@@@@@@@@@@@@@@@@@@@@@@@@@@@@@@@@@@@@@@@@@@@@@@@@@@@@@@@@@@@@@@.......................................................................................2..wx..2...............................................................................................@...q...........................@@@@@@@@@@@@@@@@@@@@@@@@@@@@@@@@@@@@@@@@@@@@@@@@@@@@@@@@@@@@@@@@@@@@@@@@@@@@@@@@@@@@@@@@@@@@@@@@@@@....................@@@/\@@@................................................
................@@..@@..@@..@@...............................................................................@@@@@@......................................................................................................................................................................@@@@..................................................................@@@@@@@@@@.............................................................................................................................................................................................................................................................................................1............................................................................@@......@@......................................................................................#===.......................................{...........................=================================........{.===============###########========##########s.............................................................................++###################################################################################++..........................................................................@@@@@@@@@@@@@@@@@@@@@@@@@@@@@@@@@@@@...............@@@......................@@.................@@@@@@@@@@@@@@@@@@@@@@@@@@@@@@@@@@@@@@@@@@@@@@@@@@@@@@@@@@@@@@@@@@@@@@@@@@@@@@@@@@@@@@@@@@@@@@@@@@@@@@@@@@@@@@.....................................................2......2..................................................................@@@.........................@@@@@@@..........................@@@@@@@@@@@@@@@@@@@@@@@@@@@@@@@@@@@@@@@@@@@@@@@@@@@@@@@@@@@@@@@@@@@@@@@@@@@@@@@@@@@@@@@@@@@@@@@@@@@....................@@@..@@@................................................
................@@@@@@@@@@@@@@...............................................................................@@@@@@....................................................................................................................................................................@@......................................................................@@@@@@@@@@...........................................................@@@@@@@@@@@@@@@@@@@@@@@@@@@@@@@@@@@@@@@@@@@@@@@@@@@@@@@@@@@@@@@@@@@@@@@@@@@@@@@@@@................................................................................................................................................1......................................................................................................................................................................................................................................................{....===============.......{.......................{..==============........#########............................................................................+#######################################################################################+++...................................................................@@@@@@@@@@@@@@@@@@@@@@@@@@@@@@@@@@@@@@@@..t.............................@@@@..........@@...........@@@@@@@@@@@@@@@@@@@@@@@@@@@@@@@@@@@@@@@@@@@@@@@@@@@@@@@@@@@@@@@@@@@@@@@@@@@@@@@@@@@@@@@@@@@@@@@@@@@@@@@@@@@@@@........................................@@@@@@......@@@@@@@@@@......@@@@@@...................................................................................................@@@............@@@@@@@@@@@@@@@@@@@@@@@@@@@@@@@@@@@@@@@@@@@@@@@@@@@@@@@@@@@@@@@@@@@@@@@@@@@@@@@@@@@@@@@@@@@@@@@@@@@....................@@@..@@@................................................
.................@@@@@@@@@@@@................................................................................@@@@@@.........................................................@@@@@@@@@@.........................................................................................................................................................................@@@@@@@@@@.............................................................................................................................................................................................................................................................................................1.................................................................................................................................................................................................................................................................=======.............................................................................................................................................++###########################################################################################++++...............................................................@@@@@@@@@@@@@@@@@@@@@@@@@@@@@@@@@@@@@@@@.....................@@................................@@@@@@@@@@@@@@@@@@@@@@@@@@@@@@@@@@@@@@@@@@@@@@@@@@@@@@@@@@@@@@@@@@@@@@@@@@@@@@@@@@@@@@@@@@@@@@@@@@@@@@@@@@@@@@@@@@@@@@@@@.....................@@@@@@........@@..........@@@@@@..........@@........@@@@@@...............................................@@@......@@@....................@@@....................@@@@@@@@@@@@@@@@@@@@@@@@@@@@@@@@@@@@@@@@@@@@@@@@@@@@@@@@@@@@@@@@@@@@@@@@@@@@@@@@@@@@@@@@@@@@@@@@@@@....................@@@@@@@@................................................
.................@@@........................................................................................................................................................@@@@/\@@@@....................................................k....................................................................................................................@@@@@@@@@@.................................................................................................l..............................................l............................................................................................................................................1........................................@@@@@@@@@@.................................................................................................................................................................................................................{...............................................................................................................................................++#################################################################################################@@@@...........................................................@@@@@@@@@@@@@@@@@@@@@@@@@@@@@@@@@@@@@@@@@@@@@@@................................................@@@@@@@@@@@@@@@@@@@@@@@@@@@@@@@@@@@@@@@@@@@@@@@@@@@@@@@@@@@@@@@@@@@@@@@@@@@@@@@@@@@@@@@@@@@@@@@@@@@@@@@@@@@@@@@@@@@@@@@@@.......................@@..................................................@@........@@@@@@..........................................................................................@@@@@@@@@@@@@@@@@@@@@@@@@@@@@@@@@@@@@@@@@@@@@@@@@@@@@@@@@@@@@@@@@@@@@@@@@@@@@@@@@@@@@@@@@@@@@@@@@@@....................@@@@@@@@................................................
..................I.........................................................................................................................................................@@@@..@@@@.........................................................................................................................................................................@@@@@@@@@@..........................................................................................................................................................................................................@@-------------------@@@@@@@@.....................................................@@@@@@@@@@..............................@@@@@@@@@@@@..........................@@@@@@@@@@-----------------------------@@.....................................................===...................................................................................................................................................................................................................................+++########################################################@@@@@@@@############ssssssssssssssssssssssssss2...........................................................@@@@@@@@@@@@@@@@@@@@@@@@@@@@@@@@@@@@@@@@@@@@@......................@@..........................qqqqqqqqqqqqqqqqqqqqqqqqqqqqqqqqqqqqqqqqqqqqqqqqqqqqqqqqqqqqqqqqqqqqqqqqqqqqqqqqqqqqqqqqqqqqqqqqqqqqqqqqqqqqqqqqqqqqqqqqq.......................................................................................@@.........................................@@@...................@@@..................@@@.....@@@@@@@@@@@@@@@@@@@@@@@@@@@@@@@@@@@@@@@@@@@@@@@@@@@@@@@@@@@@@@@@@@@@@@@@@@@@@@@@@@@@@@@@@@@@@@@@@@@....................@@/..\@@................................................
..................I................................................@@@@.....................................................................................................@@@@..@@@@..................................................@@@@@@@@@@@@@@@@@@@@@@@@@@@@@@@@@@@@@@@@@@@@@@@........................................................................@@@@@@@@@@.....................................................@@@@@@.................@@@@................@@@@.............@@@@.....................@@@@@@@@@@....................................................@@@@...................@@@@@@@@@@................................................XXXXXX@@@@@@@......................XXXXXXXX@@@@@@@@@@@@.................XXXXXXXXXXXXXXXXXXX.............................##@@.................................................======.................................................................................................................................................................+++++.......................................................+++++###########################################################@......sssssssssssssssssssssssssssssssssssssss2.......................................................@@@@@@@@@@@@@@@@@@@@@@@@@@@@@@@@@@@@@@@@@@@@@@@@@....@@@...........................................qqqqqqqqqqqqqqqqqqqqqqqqqqqqqqqqqqqqqqqqqqqqqqqqqqqqqqqqqqqqqqqqqqqqqqqqqqqqqqqqqqqqqqqqqqqqqqqqqqqqqqqqqqqqqqqqqqqqqqqqq.............................................................................................................................................@@@.....................................@@@@@@@@@@@@@@@@@@@@@@@@@@@@@@@@@@@@@@@@@@@@@@@@@@@@@@@@@@@@@@@@@@@@@@@@@@@@@@@@@@@@@@@@@@@@@@@@@@@....................qq....qq................................................
..................I................................................@@@@.................@@@@................@@@@@@@@....................................................+++++++++++++++++.............................................@@@@@@@@@@@@@@@@@@@@@@@@@@@@@@@@@@@@@@@@@@@@@@@@@@@.......................................................................0...........................................................@@@@@@@@@@...................................@@@@-------------@@@@@@...............................................................................@@@@@@...................@@@/\@@@@@@@............................................XXXXXXXXXX@@@@@...................XXXXXXXXXXXXXX@@@@@@@@@..XXXXXXXXXXXXXXXXXXXXXXXXXXXXXXXXXXX............................####@@..............................................=========...........................................................................................................................................................++++#####+++++..........++++++++++++++++++++++++++++++++++++++++################################################################@.yz...sssssssssssssssssssssssssssssssssssssss2...+++++++++...........................................@@@@@@@@@@@@@@@@@@@@@@@@@@@@@@@@@@@@@@@@@@@@@@@@@................................@@.........@@@@...qqqqqqqqqqqqqqqqqqqqqqqqqqqqqqqqqqqqqqqqqqqqqqqqqqqqqqqqqqqqqqqqqqqqqqqqqqqqqqqqqqqqqqqqqqqqqqqqqqqqqqqqqqqqqqqqqqqqqqqqq................................................................................................@@@@@@...............................................................................@@@@@@@@@@@@@@@@@@@@@@@@@@@@@@@@@@@@@@@@@@@@@@@@@@@@@@@@@@@@@@@@@@@@@@@@@@@@@@@@@@@@@@@@@@@@@@@@@@@....................qq....qq................................................
..................I.................................@@@@@@.....@@@@@@@@......@@@@@@.....@@@@..............@@@@@@@@@@@@.........................................+++++++++#################+++++++++++++..............................@@@@@@@@@@@@@@@@@@@@@@@@@@@@@@@@@@@@@@@@@@@@@@@@@@@@@@@.....................................................................0.........................................................@@@@@@@@@@@@@@.................................@@@@.............@@@@@@@@...........................................................................@@@@@@@@...................@@@..@@@@@@@@@.......................................XXXXXXXXXXXXXXX@@@.................XXXXXXXXXXXXXXXXXXXX@@@@@XXXXXXXXXXXXXXXXXXXXXXXXXXXXXXXXXXXXX...........................#######@@...........................................=============.........................=======..................................======...............................=====......................................####################++++++++++########################################################################################################@.....ssssssssssssssssssss#################@@@@############+++........................................@@@@@@@@@@@@@@@@@@@@@@@@@@@@@@@@@@@@@@@@@@@@@@@@@...............@@@@@..............................qqqqqqqqqqqqqqqqqqqqqqqqqqqqqqqqqqqqqqqqqqqqqqqqqqqqqqqqqqqqqqqqqqqqqqqqqqqqqqqqqqqqqqqqqqqqqqqqqqqqqqqqqqqqqqqqqqqqqqqqq..................................................................................................@@.................................................................................@@@@@@@@@@@@@@@@@@@@@@@@@@@@@@@@@@@@@@@@@@@@@@@@@@@@@@@@@@@@@@@@@@@@@@@@@@@@@@@@@@@@@@@@@@@@@@@@@@@....................qq....qq................................................
...@@............@@@@@@@@@@@@.......................@@@@@@.....@@@@@@@@......@@@@@@.....@@@@............@@@@@@@@@@@@@@@@...........................++++++++++++#######################################++++++++++++................@@@@@@@@@@@@@@@@@@@@@@@@@@@@@@@@@@@@@@@@@@@@@@@@@@@@@@@@@@@...................................................................0......................+++++++++++++....................@@@@@@@@@@@@@@@@@@...............................@@@@.............@@@@@@@@@@.......................................................................@@@@@@@@@@...................@@@..@@@@@@@@@@@..............................XXXXXXXXXXXXXXXXXXXXXXXXXXXXXXXX......XXXXXXXXXXXXXXXXXXXXXXXXXXXXXXXXXXXXXXXXXXXXXXXXXXXXXXXXXXXXXXXXXX...........................#########@@.......................................==================................====================.....................================....................=================...............========################################################################################################################################################@@@@@@@@######################################################++++++..................................@@@@@@@@@@@@@@@@@@@@@@@@@@@@@@@@@@@@@@@@@@@@@@@@@.................................................@@@@@@@@@@@@@@@@@@@@@@@@@@@@@@@@@@@@@@@@@@@@@@@@@@@@@@@@@@@@@@@@@@@@@@@@@@@@@@@@@@@@@@@@@@@@@@@@@@@@@@@@@@@@@@@@@@@@@@@@@@@@@@@@@@@@............@@@@........@@@@@@@@@@@@@@@@@@@@@@@@@@@@@@@@........@@@@........@@@@........@@.......................................................@.........................@@@@@@@@@@@@@@@@@@@@@@@@@@@@@@@@@@@@@@@@@@@@@@@@@@@@@@@@@@@@@@@@@@@@@@@@@@@@@@@@@@@@@@@@@@@@@@@@@@@@@@@@@@@@@@@@@@@@@@@@@@@@@@@@@@@@@@@@@@@@@@@@@@@@@@@@@@@@@@@@@@@@@@@@@@@@@@@
+++@@------------@@@@@@@@@@@@+++++++++++++++++++++++@@@@@@+++++@@@@@@@@++++++@@@@@@+++++@@@@++++++++++++@@@@@@@@@@@@@@@@+++++++++++++++++++++++++++###############################################################++++++++++++++++@@@@@@@@@@@@@@@@@@@@@@@@@@@@@@@@@@@@@@@@@@@@@@@@@@@@@@@@@@@@@@@@@@@@@@@@@@@@@@@@@@@@@@@@@@@@@@@@@@@@@@@@@@@@@@@@@@@@@@@@@@@@@@@@@@@@@@@@@++++++++++++#############++++++++++++++++++@@@@@@@@@@@@@@@@@@@@@@@@@@@@@@......@@@@@@@@@@.....@@@@.............@@@@@@@@@@@@@@@@@@@@@@@@@@@@@@@@@@@@@@@@@@@@@@@@@@@@@@@@@@@@@@@@@@@@@@@@@@@@@@@@@@@@@@@@@@@...................@@@@@@@@@@@@@@@@@@@@@@@@@@@@@@XXXXXXXXXXXXXXXXXXXXXXXXXXXXXXXXXXXXXXXXXXXXXXXXXXXXXXXXXXXXXXXXXXXXXXXXXXXXXXXXXXXXXXXXXXXXXXXXXXXXXXXXXXXXXXXXXXXXXXXXX.........................############+++++++++++++++++++++++++++++++++++++==========================....====================================.....===============================....==============================...==================################################################################################################################################################################################################################++++++++++++++++++++++++++++++++++@@@@@@@@@@@@@@@@@@@@@@@@@@@@@@@@@@@@@@@@@@@@@@@@@...........@@............@@@@.........@@@........@@@@@@@@@@@@@@@@@@@@@@@@@@@@@@@@@@@@@@@@@@@@@@@@@@@@@@@@@@@@@@@@@@@@@@@@@@@@@@@@@@@@@@@@@@@@@@@@@@@@@@@@@@@@@@@@@@@@@@@@@@@@@@@@@@@@@@@@@@@@@@@@@@@@@@@@@@@@@@@@@@@@@@@@@@@@@@@@@@@@@@@@@@@@@@@@@@@@@@@@@@@@@@@@@@@@@XXXXXXXXXXXXXX@@@@@@@@@@@@@@@@@@@@@@@@@@@@@@@@@@@@@@@@@@@@@@@@@@@@@@@@@@@@@@@@@@@@@@@@@@@@@@@@@@@@@@@@@@@@@@@@@@@@@@@@@@@@@@@@@@@@@@@@@@@@@@@@@@@@@@@@@@@@@@@@@@@@@@@@@@@@@@@@@@@@@@@@@@@@@@@@@@@@@@@@@@@@@@@@@@@@@@@@@@@@@@@@@@@@@@@@@@@@@@@@@@@@@@@@@@@@@@@@@@@@@@@@@@@

0 I visible,door
k K visible,collectable
1 | visible,door
l L visible,collectable
2 I visible,door
m M visible,collectable
3 . door
n N visible,collectable
4 . undefined
5 . undefined
a - visible
b @ visible
c | visible,door
d I undefined
e @ undefined
f . undefined
g . undefined
h . undefined
i . undefined
j . undefined
o . visible
p . visible
q @ visible,door
r A visible,collectable
s # visible,door
t B visible,collectable
u . visible
v . visible
w C visible,treasure,collectable
x D visible,treasure,collectable
y E visible,treasure,collectable
z F visible,treasure,collectable
