...........................................................................................................................................................@@@@@@@@@@@.........................................................................................................@@..@@..@@.............................................@@.....@@@@@@@@@@@@@@@@@@@@@@@@@@@@@@@@@@@@@.....@@@@@@@@@@@@@@@@@@@@@@@@@@@@@@@@@@@@@@@@@.............@@.......................................@@@@@@@@@@@@..................@@....@@....@@..@@....@@....@@....@@....@@....@@....@@....@@....@@....@@....@@..........................................@@..@@..@@..@@..@@..@@..@@..@@..@@............................................................................................................++++++++++++++....+++++++++++++++++++++.........++++++++++++.................................@@.........................................@@@@.................................................................
.......................................................................................................................................................k.............@@........................................................................................................@@@@@@@@@@.............................................@@........................................@@............................................@@@............@@.......................................@@@@@/\@@@@@..................@@@@@@@@@@@@@@..@@@@@@@@@@@@@@@@@@@@@@@@@@@@@@@@@@@@@@@@@@@@@@@@@@@@@@@@@@@@@@..........................................@@@@@@@@@@@@@@@@@@@@@@@@@@@@@@@@@@.........................................................................................................+++##############++++#####################+++++++++############++...............................@@.................@@.....@@.............@@@@@@.................................................................
......................................................................................................................................................................@@.......................................................................................................@@@@@@@@@@.............................................@@........................................@@............................................@@@@...........@@.......................................@@@@]..[@@@@------------------@@@@@@@@@@@@@@..@@@@@@@@@@@@@@@@@@@@@@@@@@@@@@@@@@@@@@@@@@@@@@@@@@@@@@@@@@@@@@..........................................@@@@@@@@@@@@@@@@@@@@@@@@@@@@@@@@@@........................................................................................................+##########=======#####===================###########==========###+++..............----------....@@@@@@@@@@@@@@..................@@..............................................................................
......................................................................................................................................................@@@@@............@@@@@@@@@@@@@@@@@@@@@@@@@@@@@@@@@@@@@@@@@@@@@@------------@@@@@@@@@@@@..................................@@@@/\@@@@.............................................@@........................................@@............................................@@@@@..........@@.......................................@@@@]..[@@@@....................1...................@@@@@@@@@@@@@@@@@@@@@@@@@@@@@@@.......................@@..........................................@@@.............................@@........................................................................................................#########===.....================================================####+++.........................@@@@@@@@@@@@@@.....................@@...........................................................................
.............................................................................@@..@@.....................................................................@@@....................................................................................................................@@@]..[@@@.............................................@@@@@@@...................................@@@@@@@.......................................@@@@@@.......r.@@..........................@@-----------@@@@@@@@@@@@..................m.1...................@@@@@@@@@@@@@@@@@@@@@@@@@@@@@@@.....l.................@@..........................................@@@.............................@@............................@@@@.......................................................................+######=====.........{........==========================....{.....===####+++++....................@@@..@@@@..@@@.........................................@@@@@....................................................
.............................................................................@@@@@@......................................................................@@....................................................................................................................@@@]..[@@@.............................................@@@@@@@@@@@@@@@@@@@@@@@@@@@@@@@@@@@@.....@@@@@@@@@@@@@@@@@@@@@@@@@@@@@@@@@@.............@@@@@@@........@@.........................@@@...........@@@@@@@@@@@@....................1...................@@@@@@@@@@@@@@@@@@@@@@@@@@@@@@@.......................@@..........................................@@@.............................@@............................@@.........................................................................####====...{....................{........======.....{................====#####+...................@@@..@@@@..@@@..................................................................................................
................@@..@@..@@..@@...............................................@]..[@.......................................................................@@...................................................................................................................@@@@@@@@@@.............................................................................................................@@..............@@@@@@@@@@@@@@@@@@@@@@@@@....................................................................@@@@@@@@@@@@@@@@@@@@...@@@@@@@@@@@@@@@@@@@@@@@@@@@@@@@....@@@@@@@@@@@@@......@@...........................................2.......................................................@@@@@@@............@@@@...........................................................#===.......................................{...........................===###...................@@@@@@@@@@@@@@.......@@.........................................................................................
................@@@@@@@@@@@@@@...............................................@@@@@@........................................................................@@@@@@@@@@@@@@@@@@@@@@@@@@@@@................@@@@@@@@@@@@@@..........@@@@@@@@@@@@@----------------------------------@@@@@@@@@@.............................................................................................................@@.....................................@@.............................................................................@@@@@@@@@@@...@@@@@@@@@@@@@@@@@@@@@@@@@@@@@@@....@@@@@@@@@@@@@@.....@@...........................................2............................................................@@............@@@@.....................................................................................................................................=##...................@@@@@@@@@@@@@@@...@@...@@....@@.@@.....@@@@@@@@.................................................................
.................@@@@@@@@@@@@................................................@@@@@@....................................................................................................@@..............@@......................................................................@@@@@@@@@@.............................................................................................................@@.....................................@@.............................................................................@@@@@@@@@@@.........................................................@@...........................................2............................................................@@..........@@@@@@@@.........................................................................................................................................................@@.........................................@@@@.................................................................
.................@@@....................................................................................................................................................................@@............@@.......................................................................@@@@@@@@@@.................................................................................@@@@@.......................@@.....................................@@......................@@.....................................................@@@@@@@@@@@.......................................................@@@@...........................................2...................................................X........@@..........@@@@@@@@.........................................................................................................................................................@@.........................................@@@@.................................................................
..................I......................................................................................................................................................................@@..........@@........................................................................@@@@@@@@@@...............................................@@@@@@@@@@@......@@@@@@@@@@@@@@@@@@@@@@@@]--------------------@@.........@@@@@.......................@@........@@------------@@@@@@-----------@@@@@@@@@@@@------------....-@@.......@@@@@@@@@@@......................................................@@@@@..........................................@@@.............................@@...................X........@@......@@@@@@@@@@@@@@@@@@.............@@.................................+++=...............................................................................................@@.........................................@@@@.................................................................
..................I...................................................................................................................................@@@@@@@@@@@@@@@@@@@@@@@@@@@@@@......@@@@@@@@@@@@......@@@@@@@@@@@@@@@@@@@@@@@@@@@@@@.....................................@@@@@@@@@@.............................................@@@@...................................................................@@@@@@@@@@@@@@@@@@@@@@@@@@@@@@@@@@.......@@@............@@@@@@...........@@@@@@@@@@@@.................@@@......@@@@@@@@@@@@@@@@@@@@@@@@@@@@@@@@@@@@@@@@@@@@@@..@@@@@@@@@@@@@@@@@@@@@@.......................................XXX@@@...........................==@@XXXXXX............XXX.......@@............@@@@@@@@@@@@----------.--@@@@..............................+###==..................................................................................................................................@@.....@@@@.................................................................
..................I.........................................................@@@@@@@@...............................................................................................@@......................@@@@@@@@@@@@@@@@@@@@@@@@@@@@@@@@.....................................0...................................................@@@@@@...........................................................................................................@@@@............@@@@@@...........@@@@@@@@@@@@.................@@@@................................................................................................................XXXXX@@@====.....................====@@XXXXXXXXX.........XXX.......@@............@@@@@@@@@@@@.............@@@@@@............................###=====.......................................................................+++...................................@@@@.............@@.......@@@@.................................................................
..................I.......................................................@@@@@@@@@@@@..........................+++++++++++++++.....................................................@@....................@@@@@@@@@@@@@@@@@@@@@@@@@@@@@@@@@@....................................0...................++++++++++++++++++............@@@@@@@@..........................................................................................................@@@@@............@@@@@@...........@@@@@@@@@@@@.................@@@@@.......................................................................................XXXX.................XXXXXXXX@@@@@@@@@@@@@@@@@....@@@@@@@@@@@@@XXXXXXXXXXXXX...XXXXX.......@@............@@@@@@@@@@@@.............@@@@@@@@.........................+##=========.........................=======..................................#####+.................................................@@.........@@@@.................................................................
.................@@@@@@@@@@@@.........yz................................@@@@@@@@@@@@@@@@................++++++++###############++++++++++............................................@@..................@@@@@@@@@@@@@@@@@@@@@@@@@@@@@@@@@@@@...................................0.............++++++##################++++++....@@@@@@@@@@.........@@@@@@..........................................................................................@@@@@@............@@@@@@...........@@@@@@@@@@@@.................@@@@@@...................................................................................XXXXXXXXX........XXXXXXXXXXXXXXX@@@@@@@@@@@@@@@@@....@@@@@@@@@@@@@XXXXXXXXXXXXXXXXXXXXXX......@@............@@@@@@@@@@@@.............@@@@@@@@@@.....................++###============................====================.....................=========###++++.............@@..........@@.............................@@@@........++++++++++++.............................................
+++@@------------@@@@@@@@@@@@+++++++++++++++++++++++++++++++++++++++++++@@@@@@@@@@@@@@@@++++++++++++++++#################################+++++++++@@@@@@@@@@@@@@@@@@@@@@@@@@@@@@@@@@@@@@@@@@@@@@@@@@@@@@@@@@@@@@@@@@@@@@@@@@@@@@@@@@@@@@@@@@@@@@@@@@@@@@@@@@@@@@@@@@@@@@@@@@@@@@@@@@@@@@@@@+++##############################++@@@@@@@@@@@@@@@@@@@@@@@@@@@@@@@@@@@@@@@@@@@@@@@@@@@@....................@@@@@@@@@@@@@@@@@@@@@@@@@@@@@@@@@@@@@@@@@@@@@@@@@@@............@@@@@@...........@@@@@@@@@@@@.................@@@@@@@@@@@@@@@@@@@@@@@@@@@@@@@@@@@@@@@@@@@@@@@@@@@@@@@@@@@@@@@@@@@@@@@@@@@@@@@@@@@@@XXXXXXXXXXXXXXXXX..XXXXXXXXXXXXXXXXXXXXXXXXXXXXXXXXXX....XXXXXXXXXXXXXXXXXXXXXXXXXXXXXXXXXXX......@@............@@@@@@@@@@@@.............@@@@@@@@@@+++++++++++++++++++++####===========================================================.....=================#####+++++++++++++@@@@@@@@@@@@@@..........@@@@...............@@@@........############+++++++++++++++++++++++++++++++++++++++++++++

0 I visible,door
k K visible,collectable
1 | visible,door
l L visible,collectable
2 I visible,door
m M visible,collectable
3 . invisible,door
n N visible,collectable
4 . invisible
5 . invisible
a - visible
b @ visible
c | invisible
d I invisible
e @ invisible
f . invisible
g . invisible
h . invisible
i . invisible
j . invisible
o . visible
p . visible
q . visible
r A visible,collectable
s . visible
t . visible
u . visible
v . visible
w C visible,collectable,treasure
x D visible,collectable,treasure
y E visible,collectable,treasure
z F visible,collectable,treasure
