.............................................................................................................................................................................................................................................................................................................+++++++++++...........................................................................................................................................................................@@@..........@@......@@@......@@@@@@......@@@@@@@@@@@@.........................................................................................@@..@@..@@............................................................................................................@@..@@..@@............................................................................................................s.+++++++++++++++++++++++++......................++++++++++++.........................................................................................................................................................................................+++++++++++++++++++++...............+++++++++++++++++++++++++++++++......................++++++++++++++++++++++++++++++++++++++++++++++++++++++++++++++++++...........................@@@@@.................................................@@@@@@@@@@@@@@@@@@@@@@@@@@@@@@@@@@@@--------------------------------------------------@@@@....@@@@@@@@@@@@@@@@@@@@@@@@@@@@@@@@@@@@@@@@@@@@@@@@@@@@@@@@@@@@@@@@@@@@@@@@....................................................................................@@.@.@@.........................................................................................................@......@................................@@.@@.@@................................................
.......................................................................................................................................................................................................................................................................................................++++++###########+++++......................................................................................................................................................................@@@...@@@............@@@@@@@@@@@@@@@.........@@@@@@@@@.........................................................................................@@@@@@@@@@....................................................@@..@@..@@..............................................@@@@@@@@@@..........................................................................................................+s.r#########################++++++++++++++++++++++############++........................................+++++++++...................................................................................................................................+++#####################+++++++++++++++###############################+++++++.......++++++++#################################################################----------------------------@@@@@.................................................@@@@@@@@@@@@@@@@@@@@@@@@@@@@@@@@@@@@..........................................................@@@@@@@@@@@@@@@@@@@@@@@@@@@@@@@@@@@@@@@@@@@@@@@@@@@@@@@@@@@@@@@@@@@@@@@@@@..................................................................................@@@@@@@...................@@@...................................................................................@@.@@.@@................................@@@@@@@@................................................
...................................................................................................................................................................................................................................................................................................++++######################+++...................................................................................................................................................................@@@...@@@............@@@@@@@@@@@@@@@.........@@@@@@............................................................................................@@@@@@@@@@....................................................@@@@@@@@@@..............................................@@@@@@@@@@.........................................................................................................+#s############==============########################==========###+++++.............................++++++#########++++++...........................................................................................................................++#############################################################################+++++++###########################################################...........................................@@...................................................@@@@@@@@@@@@@@@@@@@@@@@@@@@@@@@@@@@@..........................................................@@@@@@@@@@@@@@@@@@@@@@@@@@@@@@@@@@@@@@@@@@@@@@@@@@@@@@@@@@@@@@@@@@@@@@@@@@@@.................................................................@@@.............@........@@@.....@@@...........................................................................................@@@@@@@@................................@@@@@@@@................................................
..............................................................................................................?................................................................................................................................................................................++++#############################++.......................................................................................................................................................................@@@............@@@@@@@@@@@@@@@.........@@@@@@@@@.........................................................................................@@..@@..@@....................................................@@@@@@@@@@..............................................@@..@@..@@.........................................................................................................#########===============================#####====================######+++++++++............++++++++#######=======#######++++++..................+++++++..........................................................................................++###########################################################################################################################################.................................................@@..............................................@@@@@@@@@@@@@@@@@@@@@@@@@@@@@@@@@@@@@@@@@..........................................................@@@@@@@@@@@@@@@@@@@@@@@@@@@@@@@@@@@@@@@@@@@@@@@@@@@@@@@@@@@@@@@@@@@@@@@@@@@@@@........................................................@@@...........@@@......@...q..........................................................................................................2......0................................@@@@@@@@................................................
................................................................@.....^..@...................................@@..@@.........................................................................................................................................................................+++###################################+..................................................................................................................................................................k...@@@............@@@@@@@@@...@@@@@.......@@@@@@@@@.........................................................................................@@@@@@@@@@............................................................................................................@@@@@@@@@@........................................................................................................+######=====.........{........==========================....{.....=====##########++++++++++++#########===================#######++++.........+++++#######+++++....................................................................................+############################################################################################################################################..................................................@@......@@@@....................................@@@@@@@@@@@@@@@@@@@@@@@@@@@@@@@@@@@@@@@@@.....................@@...............................@@@@@@@@@@@@@@@@@@@@@@@@@@@@@@@@@@@@@@@@@@@@@@@@@@@@@@@@@@@@@@@@@@@@@@@@@@@@@@@@@@...............................................................................@.m.q...........................@@@@@@@@@@@@@@@@@@@@@@@@@@@@@@@@@@@@@@@@@@@@@@@@@@@@@@@@@@@@@@@@@@@@@@.........2......0................................@@@@@@@@................................................
................................................................@@@@@@@@@@...................................@@@@@@.......................................................................................................................................................................++#######################################++.............................................................................................................................................................................................................................................................................................................@@@@@@@@@@............................................................................................................@@@@@@@@@@........................................................................................................####====...{....................{........======.....{................===========##############=================================#####+++++++++#################+..................................................................................+##################################################.........................##################################################################.........###########..............................@@......@@@@....................................@@@@@@@@@@@@@@@@@@@@@@@@@@@@@@@@@@@@...............@@@................................@@.......@@@@@@@@@@@@@@@@@@@@@@@@@@@@@@@@@@@@@@@@@@@@@@@@@@@@@@@@@@@@@@@@@@@@@@@@@@@@@@@@@@...............................................................................@...q...........................@@@@@@@@@@@@@@@@@@@@@@@@@@@@@@@@@@@@@@@@@@@@@@@@@@@@@@@@@@@@@@@@@@@@@@.........2..wx..0................................@@@/\@@@................................................
................@@..@@..@@..@@...............................................................................@@@@@@.....................................................................................................................................++++++++++++....................++###########################################++............................................................................................................................................................@@@@@@@@@....@@@@................@@@.........@@@@@@@@@...............................................................................................................................................................................................................@@......@@..........................................................................................................#===.......................................{...........................=================================........{.===============###########========#########+...............................................................................++##################################################...........................................################################################.....#################.............................@@.......@@.....................................@@@@@@@@@@@@@@@@@@@@@@@@@@@@@@@@@@@@........................................@@.................@@@@@@@@@@@@@@@@@@@@@@@@@@@@@@@@@@@@@@@@@@@@@@@@@@@@@@@@@@@@@@@@@@@@@@@@@@@@@@@@@@..................................................@@@.........................@@@@@@@..........................@@@@@@@@@@/\@@@@@@@@@@/\@@@@@@@@@@/\@@@@@@@@@@/\@@@@@@@@@@/\@@@@@@@@@@.........2......0................................@@@..@@@................................................
................@@@@@@@@@@@@@@...............................................................................@@@@@@.................................................................................................................................++++############++++++...........+++###############################################+++..................................................................................................................................................................................................@@@........0.........................................................................................................................................................................................................................................................................................................................................................................................................V....{....===============.......{.......................{..==============........#########............................................................................++####################################################............................................######################..............................#################............................@@@@@.....@@.................................@@@@@@@@@@@@@@/\@@@@@/\@@@@@@@@@@@@@@@@@..t.............................@@@@..........@@...........@@@@@@@@@@@@@@@@@@@@@@@@@@@@@@@@@@@@@@@@@@@@@@@@@@@@@@@@@@@@@@@@@@@@@@@@@@@@@@@@@@...@@...........................................................................................@@@............@@@@@@@@@@..@@@@@@@@@@..@@@@@@@@@@..@@@@@@@@@@..@@@@@@@@@@..@@@@@@@@@@........@@@@@@@@@@......@@.......................@@@..@@@................................................
.................@@@@@@@@@@@@..........................................................................V.....@@@@@@.........................................................@@@@@@@@@@........................................................++++++######################++......+++#####################################################++++.........................................................................................................................................................................................................0......................................................@@.@@.@@........................................................................................................................................................................................................................................................................................................V..................................................======................V...........................................................................................................................++++#####################################################......##################.....................#####################...............................#################.........................................................................@@@@@@@@@@@@@@..@@@@@..@@@@@@@@@@@@@@@@@.....................@@................................@@@@@@@@@@@@@@@@@@@@@@@@@@@@@@@@@@@@@@@@@@@@@@@@@@@@@@@@@@@@@@@@@@@@@@@@@@@@@@@@@@@@@@@@@@@@@@@@@@@@@@@@@@@@@@@@@@@@@@@@@.....................@@@......@@@...................@@@@....................@@@@@@@@@@..@@@@@@@@@@..@@@@@@@@@@..@@@@@@@@@@..@@@@@@@@@@..@@@@@@@@@@.........@@@@@@@@..............@@................@@@@@@@@................................................
.................@@@........................................................................................................................................................@@@@/\@@@@....................................................++++##############################++++++############################################################++++.....................................................................................................................................................................................................0.........................@@...............@@..........@@@@@@@@..........................................................................................@@@@@@@@@@.........................................................................................................................................................................................................................................................{...............................................................................................................................................########################################################.....#####################################....#####################..............................##################.........................................................................@@@@@@@@@@@@@@..@@@@@..@@@@@@@@@@@@@@@@@@@@@@@@................................................@@@@@@@@@@@@@@@@@@@@@@@@@@@@@@@@@@@@@@@@@@@@@@@@@@@@@@@@@@@@@@@@@@@@@@@@@@@@@@@@@@@@@@@@@@@@@@@@@@@@@@@@@@@@@@@@@@@@@@@@@........................@...................................................@@@@@@@@@@..@@@@@@@@@@..@@@@@@@@@@..@@@@@@@@@@..@@@@@@@@@@..@@@@@@@@@@.................................................@@@@@@@@................................................
..................I.................................................................................................................V.......................................@@@@..@@@@............................................++++++++########################################################################################################+++..................................................................@@-------------------@@@@@@@@...................................................................................................0.......................@@@@---------------@@..........@@@@@@@@............................@@@@@@@@@@..................................................@@@@@@@@@@@@..............................................@@@@@@@@@@-------------------------------------------------==..............................................................................................................................................................................................................................................................................................#############################................................####################################......####################..............##################################.........................................................................@@@@@@@@@@@@@@..@@@@@..@@@@@@@@@@@@@@@@@@@@@@...@@.................@@..........................@@@@@@@@@@@@@@@@@@@@@@@@@@@@@@@@@@@@@@@@@@@@@@@@@@@@@@@@@@@@@@@@@@@@@@@@@@@@@@@@@@@@@@@@@@@@@@@@@@@@@@@@qqqqqqqqqqqqqqqq................@@........@@@...................@@@..................@@@.....@@@@@@@@@@@@@@@@@@@@@@@@@@@@@@@@@@@@@@@@@@@@@@@@@@@@@@@@@@@@@@@@@@@@@@.....................................@@..........@@/..\@@................................................
..................I................................................V........................................................................................................@@@@..@@@@.......................................+++++###################################################################################################################++++............................................................@@@@...................@@@@@@@@@@.............................................@@@@@@@@@@@@...............@@@@@@@@@@@@@@@@@@@@@@@@@@@@@@@@@@@@@@@@@@@@@@@@@@@@@...............@@...........................................XXXXXX@@@@@@@..........................................XXXXXXXX@@@@@@@@@@@@..........XXXXXXXX...................XXXXXXXXXXXXXXXXXXX.................................................====..................................................=====................................................................................................................................................................++++++................................................................1..........................................................####################################........##################.............####################################+...........................+++++++++++++............................@@@@@@@@@@@@@@@@@@@@@@@@@@@@@@@@@@@@@@@@@@@@@@@@@..................................................@@@@@@@@@@@@@@@@@@@@@@@@@@@@@@@@@@@@@@@@@@@@@@@@@@@@@@@@@@@@@@@@@@@@@@@@@@@@@@@@@@@@@@@@@@@@@@@@@@@@qqqqqqqqqqqqqqqqqqqq@....................................@@@.....................................@@@@@@@@@@@@@@@@@@@@@@@@@@@@@@@@@@@@@@@@@@@@@@@@@@@@@@@@@@@@@@@@@@@@@@.................................................qq....qq................................................
..................I.........................................................................................@@@@@@@@....................................................+++++++++++++++++...............................+++++############################################################################################################################+++++.....................................................@@@@@@...................@@@/\@@@@@@@.........................................@@@@@@@@@@@@@@@@@@@@@@@@@@@@@@@@@@@@@@@@@@@@@@@@@@@@@@@@@@@@@@@@@@@@@@@@@@@@@@@@@@...............XXXX.......................................XXXXXXXXXX@@@@@.......................................XXXXXXXXXXXXXX@@@@@@@@@..XXXXXXXXXXXXXXXXXXXXX.......XXXXXXXXXXXXXXXXXXXXXXXXXXX................................................======..............................................=========...........................................................................................................................................................+++######+++++..........++++++++++++++++++++++++++++++++++++++++++++.....1........................................................##########################...................................................#####################################+++++++++++++++......++++++#############+...........................@@@@@@@@@@@@@@@@@@@@@@@@@@@@@@@@@@@@@@@@@@@@@@@@@................................@@.........@@@@...@@@@@@@@@@@@@@@@@@@@@@@@@@@@@@@@@@@@@@@@@@@@@@@@@@@@@@@@@@@@@@@@@@@@@@@@@@@@@@@@@@@@@@@@@@@@@@@@@@@qqqqqqqqqqqqqqqqqqqqq@@@@..........................................................................0.....................................................................................................................qq.l..qq................................................
..................I................................................++++++++++.............................@@@@@@@@@@@@.........................................+++++++++#################+++++++++++++............++++++######################################################################################################################################+++................................................@@@@@@@@...................@@@..@@@@@@@@@.....................................@@@@@@@@@@@@@@@@@@@@@@@@@@@@@@@@@@@@@@@@@@@@@@@@@@@@@@@@@@@@@@@@@@@@@@@@@@@@@@@@@@@@..............XXXXXX...................................XXXXXXXXXXXXXXX@@@.................XXXX................XXXXXXXXXXXXXXXXXXXX@@@@@XXXXXXXXXXXXXXXXXXXXXXXXXXXXXXXXXXXXXXXXXXXXXXXXXXXXXXXXX...............................................=========...............======......................=============.........................=======..................................======...............................=====......................................####################++++++++++############################################+....1..............................###################################################..yz................................................####################################################++++++####################++.........................@@@@@@@@@@@@@@@@@@@@@@@@@@@@@@@@@@@@@@@@@@@@@@@@@...............@@@@@..............................@@@@@@@@@@@@@@@@@@@@@@@@@@@@@@@@@@@@@@@@@@@@@@@@@@@@@@@@@@@@@@@@@@@@@@@@@@@@@@@@@@@@@@@@@@@@@@@@@@@qqqqqqqqqqqqqqqqqqqqq@@@@..........................................................................0.....................................................................................................................qq....qq................................................
...@@............@@@@@@@@@@@@..................................++++##########++++++.......^.............@@@@@@@@@@@@@@@@...........................++++++++++++#######################################++++++++++++###############################################################################################################################################++++++++++....................................@@@@@@@@@@...................@@@..@@@@@@@@@@@..............@@@@@@@@@@@@@@@@@@@@@@@@@@@@@@@@@@@@@@@@@@@@@@@@@@@@@@@@@@@@@@@@@@@@@@@@@@@@@@@@@@@@@@@@@@@@@@@@@@@@@@@@@..............XXXXXX.......@@@@@@@@.............XXXXXXXXXXXXXXXXXXXXXXXXXXXXXXXX......XXXXXXXXXXXXX.......XXXXXXXXXXXXXXXXXXXXXXXXXXXXXXXXXXXXXXXXXXXXXXXXXXXXXXXXXXXXXXXXXXXXXXXXXXXXXXXXXXXXXX...............................................===========.......===================.............==================................====================.....................================....................=================...............========##########################################################################################################################################################################....................................................#################################################################################+++......................@@@@@@@@@@@@@@@@@@@@@@@@@@@@@@@@@@@@@@@@@@@@@@@@@.................................................@@@@@@@@@@@@@@@@@@@@@@@@@@@@@@@@@@@@@@@@@@@@@@@@@@@@@@@@@@@@@@@@@@@@@@@@@@@@@@@@@@@@@@@@@@@@@@@@@@@@@@@@@@@@@@@@@@@@@@@@@@@@@@@@@@@@@@......................................@..........................0.............................................................................................@@@@@@@@@@@@@@@@@@@@@@@@@@@@@@@@@@@@@@@@@@@@@@@@@@@@@@@@@@@@@@@@@@@@@@@@@@@@@@@@
+++@@------------@@@@@@@@@@@@++++++++++++++++++++++++++++++++++####################+++++++++++++++++++++@@@@@@@@@@@@@@@@+++++++++++++++++++++++++++########################################################################################################################################################################################################################@@@@@@@@@@@@@@@@@@@@@@@@@@@@@@@@@@@@@@@@@@@@@@...................@@@@@@@@@@@@@@@@@@@@@@@@@@@@@@@@@@@@@@@@@@@@@@@@@@@@@@@@@@@@@@@@@@@@@@@@@@@@@@@@@@@@@@@@@@@@@@@@@@@@@@@@@@@@@@@@@@@@@@@@@@@@@@@@@@@@@@@..............XXXXXXXXXXXXXXXXXXXXXXXXXXXXXXXXXXXXXXXXXXXXXXXXXXXXXXXXXXXXXXXXXXXXXXXXXXXXXXXXXXXXXXXXXXXXXXXXXXXXXXXXXXXXXXXXXXXXXXXXXXXXXXXXXXXXXXXXXXXXXXXXXXXXXXXXXXXXXXXXXXXXXXXXXXXXXXXXXXX.............................................===========================================================================....====================================.....===============================....==============================...==================##############################################################################################################################################################################################################################################################################################################++++++++++++++++++++++@@@@@@@@@@@@@@@@@@@@@@@@@@@@@@@@@@@@@@@@@@@@@@@@@.........@@@@............@@@@.........@@@........@@@@@@@@@@@@@@@@@@@@@@@@@@@@@@@@@@@@@@@@@@@@@@@@@@@@@@@@@@@@@@@@@@@@@@@@@@@@@@@@@@@@@@@@@@@@@@@@@@@@@@@@@@@@@@@@@@@@@@@@@@@@@@@@@@@@@@@@@@@@@@@@@@@@@@@@@@@@@@@@@@@@@@@@@@@@@@@@@@@@@@@@@@@@@@@@@@@@@@@@@@@@@@@@@@@@@@@@@@@@@@@@@@@@@@@@@@@@@@@@@@@@@@@@@@@@@@@@@@@@@@@@@@@@@........................@@@@@@@@@@@@@@@@@@@@@@@@@@@@@@@@@@@@@@@@@@@@@@@@@@@@@@@@@@@@@@@@@@@@@@@@@@@@@@@@

0 I visible,door
k K visible,collectable
1 | visible,door
l L visible,collectable
2 I visible,door
m M visible,collectable
3 . door
n N visible,collectable
4 . undefined
5 . undefined
a - visible
b @ visible
c | visible,door
d I undefined
e @ undefined
f . undefined
g . undefined
h . undefined
i . undefined
j . undefined
o . visible
p . visible
q @ visible,door
r A visible,collectable
s # visible,door
t B visible,collectable
u . visible
v . visible
w C visible,treasure,collectable
x D visible,treasure,collectable
y E visible,treasure,collectable
z F visible,treasure,collectable
