..............................................................................................................................................................................................................................................................@@..@@..@@...............................................................................................................................@@..@@..@@..........................................................................................................................................@@@@@@@@@@@@@....@@@@@@@@@@@@@@@@@@@@@...........................................@@..@@..@@..@@..@@..@@........@@@@...................................................................
.....................................................................................................................................................................................................................................................@@.......@@@@@@@@@@...............................................................................................................................@@@@@@@@@@.....................................................................@@@@@@@@@@@@@@@@@@@@@.....@@@@@@@@@@@@@@@......@@@@@@................@@@@@@@@@@@@@...@@@@@@@@@@@@@@@@@@@@@@...........................................@@@@@@@@@@@@@@@@@@@@@@......@@@@@@...................................................................
.....................................................................................................................................................................................................................................................@@.......@@@@@@@@@@...............................................................................................................................@@@@@@@@@@.....................................................................@@...............@@@.......@@@.......................................@@@@@@@@@@@@@@..@@@@@@@@@@@@@@@@@@@@@@...........................................@@@@@@@@@@@@@@@@@@@@@@......@@@@@@...................................................................
......................................................................................................................................................@@@..............@@@@@@@@@@@@@@@@@@@@@@@@@@@@@@@@@@@@@@@@@@@@@@@@........@@@@@@@@@@@@@@--------@@.......@@@@/\@@@@...............................................................................................................................@@@]..[@@@...............................................................@@@...@@................c.........c......................................@@@@@@@@@@@@@@@@..@@@@@@@@@@@@@@@@@@@@@@...........................................@@@.........................@@@@@@...................................................................
.............................................................................@@..@@.....................................................................@@....................................................................................................@@@]..[@@@...............................................................................................................................@@@@@@@@@@...............................................................@@@...@@................c.........c....................................@@@@@@@@@@@@@@@@@@..@@@@@@@@@@@@@@@@@@@@@@...........................................@@@.......................@@@@@@@@........--------@@@@........@@@@....@@@@@@@@.......................
.............................................................................@@@@@@......................................................................@@...................................................................................................@@@]..[@@@...............................................................................................................................@@@@@@@@@@...............................................................@@@...@@................c.........c..................................@@@@@@@@..@@@@@@..@@..@@..@@@@@@..@@@@@@..@@...........................................@@@.................................................@@........@@............@@.......................
................@@..@@..@@..@@...............................................@]..[@.......................................................................@@..................................................................................................@@@@@@@@@@....................................................................................................................................................................................................@@..@@.....@..@@@@@@@@@@@@@@@@.......@@@@@@@@@@@@@@@@...@@@@@@@....@@@@@@@@@@@@@@..@@@@@@..@@..@@..@@@@@@..@@@@@@..@@............................................d..................................................@@@@....@@@@............@@@@.....................
................@@@@@@@@@@@@@@...............................................@@@@@@........................................................................@@@@@@@@@@@@@@@@@@@@@@@@@@@@.................@@@@@@@@@@@@@@@@......@@@@@@@@@@@@@@@-----------------@@@@@@@@@@.....................................................................................................................................................................................................@.........................@@@--...--@@@.....................@@....@@@@@@@@@@@@@@@@@@@@@@@@@@..@@@@@@@@@@@@@@@@@@@@@@............................................d.............@@----@@.............................@@......................@@@@.....................
.................@@@@@@@@@@@@................................................@@@@@@...................................................................................................@@...............@@...............................|.....................@@@@@@@@@@.................................................................................................................@@@@@@.........................................................................................................c.........c......................@@....@@@@@@@@@@@@@@@@@@@@@@@@@@..@@@@@@@@@@@@@@@@@@@@@@............................................d..................................................@@......................@@@@@@...................
.................@@@...................................................................................................................................................................@@.............@@................................|.....................@@@@@@@@@@.............................................................................................................................................................................................@@@@...............................c.........c......................@@....@@@@@@@@@@@@@@@@@@@@@@@@@@..@@@@@@@@@@@@@@@@@@@@@@............................................d..............................@@..................XX......................@@@@@@...................
..................I.....................................................................................................................................................................@@...........@@.................................|.....................@@@@@@@@@@............................................................................+++++++..........++++++++++++]------aaaaaaaa------[@@@@@@@@@@@+.................................................@@@@@...............................c.........c......................@@....@@@@@@@@@@@@@@@@@@@@@@@@@@..@@@@@@@@@@@@@@@@@@@@@@...............XXXX........................@@@@@@@@@@@.....................@@XXX...............XX................----@@@@@@@@@@@@@@....@@@@@@@@@
..................I...................................................................................................................................@@@@@@@@@@@@@@@@@@@@@@@@@@@@@@.....@@@@@@@@@@@@@......@@@@@@@@@@@@@....@@@@@@@@@@@@@....................@@@@@@@@@@..............................................................++++++++++++++#######++++++++++############@....................@@@@@@@@@@@@#+..........................................+++...@@@@@..@@@...@@...@@..@@@@@@@@@@@@@@@@@@@@@@@@@@@@@@@@@@@@@@.....@@@@@@....@@@@@@@@@@@@@@@@@@@@@@@@@@..@@@@@@@@@@@@@@@@@@@@@@.............XXXXXXXXX..................XXX@@@@@@@@@@@@@...................@@XXXXXX............XXX.....................@@@@@@@@@@@@----@@.......
..................I.........................................................@@@@@@@@...............................................................................................@@......................@@............................@@.........................................................................................@@###########################################@....................@@@@@/\@@@@@##++........................................###...@@@@....@@..@@@...@@.....................................................................................................................XXXXXXXXXX......XX........XXXXXXXXXXXXXXXX@@@@..........@@@@...@@XXXXXXX...........XXX.....................@@@@@@@@@@@@....@@.......
..................I.......................................................@@@@@@@@@@@@..........................+++++++++++++++.....................................................@@....................@@..............................@@......................................................................................@@@@###########################################@....................@@@@]..[@@@@####++................................+++...####..@@@@@...@@..@@@...@@...................................................................................................................XXXXXXXXXXXXX....XXXX......XXXXXXXXXXXXXXXXXXX@@@@....@@@@@XX@@@@@@XXXXXXX.........XXXXX.......X............XX@@@@@..@@@@....@@.......
.................@@@@@@@@@@@@...........aabbccdd........................@@@@@@@@@@@@@@@@................++++++++###############++++++++++............................................@@..................@@................................@@...................................................................................@@@@@@###########################################@....................@@@@]..[@@@@######+++++..........................####...####..@@@@@...@@..@@@...@@..................................................................................................................XXXXXXXXXXXXXX....XXXXX.....XXXXXXXXXXXXXXXXXXXXXXX....XXXXXXXXXXXXXXXXXXXXX........XXXXXX......XX...........XXXX@@@..@@@@....@@.......
+++@@------------@@@@@@@@@@@@+++++++++++++++++++++++++++++++++++++++++++@@@@@@@@@@@@@@@@++++++++++++++++#################################+++++++++@@@@@@@@@@@@@@@@@@@@@@@@@@@@@@@@@@@@@@@@@@@@@@@@@@@@@@@@@@@@@@@@@@@@@@@@@@@@@@@@@@@@@@@@@@@@@@@@@@@@@@@@@@@@@@@@@@@@@@@@++++++++++++++++++++++++++++++++++++++++++++++++++++@@@@@@@@###########################################@....................@@@@@@@@@@@@###########++++++++++++++++++++++....####...####..@@@@@..@@@..@@@...@@@@@@@@@@@@@@@@@@@@@@@@@@@@@@@@@@@@@@@@@@@...@@@@@@@@@@@@@@@@@@@@@@@@@@@@@@@@@@@@@@@@@@@@@@@@@@@@@@@@@@@@@@@.....XXXXXXXXXXXXXXXXX..XXXXXXX...XXXXXXXXXXXXXXXXXXXXXXXX....XXXXXXXXXXXXXXXXXXXXX.......XXXXXXX.....XXXX.........XXXXX@@@@@@@@@....@@.......

a - 1
b @ 1
c | 0
d I 0
