...........................................................................................................................................................-------@@@@........................................................................................@@..@@..@@..............................................................@@.....@@@@@@@@@@@@@@@@@@@@@@@@@@@@@@@@@@@@@.....@@@@@@@@@@@@@@@@@@@@@@@@@@@@@@@@@@@@@@@@@.............??.......................................@@@@@@@@@@@@..................@@....@@....@@..@@....@@....@@....@@..@@....@@....@@..@@....@@....@@....@@....@@........................................@@..@@..@@..@@..@@..@@..@@..@@..@@...................................................................
.....................................................................................................................................................................@@.......................................................................................@@@@@@@@@@..............................................................@@........................................@@............................................@@@............@@.......................................@@@@@@@@@@@@..................@@@@@@@@@@@@@@..@@@@@@@@@@@@@@@@@@@@..@@@@@@@@@@@@@@..@@@@@@@@@@@@@@@@@@@@@@@@@@........................................@@@@@@@@@@@@@@@@@@@@@@@@@@@@@@@@@@...................................................................
......................................................................................................................................................................@@......................................................................................@@@@@@@@@@..............................................................@@........................................@@............................................@@@@...........@@.......................................@@@.@@@@.@@@------------------@@@@@@@@@@@@@@..@@@@@@@@@@@@@@@@@@@@..@@@@@@@@@@@@@@..@@@@@@@@@@@@@@@@@@@@@@@@@@........................................@@@@@@@@@@@@@@@@@@@@@@@@@@@@@@@@@@...................................................................
......................................................................................................................................................@@@@@............@@@@@@@@@@@@@@@@@@@@@@@@@@@@@@@@@@@@@@@@@@@@@@------------@@@@@@@@@@@@.................@@@@/\@@@@..............................................................@@........................................@@............................................@@@@@..........@@.......................................@@@.@@@@.[@@..................@@@@@@@@@@@@@@................................................................@@........................................@@@.............................@@...................................................................
.............................................................................@@..@@.....................................................................@@@...................................................................................................@@@]..[@@@..............................................................@@@@@@@...................................@@@@@@@.......................................@@@@@@.........@@..........................@@-----------@@@@@@@@@@@@..................@@@@@@@@@@@@@@................................................................@@........................................@@@.............................@@........--------@@@@........@@@@....@@@@@@@@.......................
.............................................................................@@@@@@......................................................................@@...................................................................................................@@@]..[@@@..............................................................@@@@@@@@@@@@@@@@@@@@@@@@@@@@@@@@@@@@.....@@@@@@@@@@@@@@@@@@@@@@@@@@@@@@@@@@.............@@@@@@@........@@.........................@@@...........@@@@@@@@@@@@..................@@@@@@@@@@@@@@................................................................@@........................................@@@.................................................@@........@@............@@.......................
................@@..@@..@@..@@...............................................@]..[@.......................................................................@@..................................................................................................@@@@@@@@@@..............................................................................................................................@@..............@@@@@@@@@@@@@@@@@@@@@@@@@.....................................................................@@@@@@@@@@@@@@@@@@@@..@@@@@@@@@@@@bb@@@@@@@@@@@@@@@....@@@@@@@@@@@@@@@@.......@@.........................................d..................................................@@@@....@@@@............@@@@.....................
................@@@@@@@@@@@@@@...............................................@@@@@@........................................................................@@@@@@@@@@@@@@@@@@@@@@@@@@@@@................@@@@@@@@@@@@@@..........@@@@@@@@@@@@@-------..--------@@@@@@@@@@..............................................................................................................................@@.....................................@@.............................................................................@@@@@@@@@@@@..@@@@@@@@@@@@..@@@@@@@@@@@@@@@....@@@@@@@@@@@@@@@@@@.....@@.........................................d.............@@----@@.............................@@......................@@@@.....................
.................@@@@@@@@@@@@................................................@@@@@@....................................................................................................@@..............@@...............................|.....................@@@@@@@@@@..............................................................................................................................@@.....................................@@.............................................................................@@@@@@@@@@@@..@@@@@@@@@@@@............................................@@.........................................d..................................................@@......................@@@@@@...................
.................@@@....................................................................................................................................................................@@............@@................................|.....................@@@@@@@@@@..................................................................................................@@@@@.......................@@.....................................@@......................@@.....................................................@@@@@@@@@@@@..@@@@@@@@@@@@..........................................@@@@.........................................d..............................@@..................XX......................@@@@@@...................
..................I......................................................................................................................................................................@@..........@@.................................|.....................@@@@@@@@@@................................................................@@@@@@@@@@@.....@@@@@@@@@@@@@@@@@@@@@@@@@]--------------------@@.........@@@@@.......................@@........@@------------@@@@@@-----------@@@@@@@@@@@@-------....-------@@@@@...@@@@@@@@@@@@..@@@@@@@@@@@@.........................................@@@@@........................................@@@.............................@@XXX...............XX................----@@@@@@@@@@@@@@....@@@@@@@@@
..................I...................................................................................................................................@@@@@@@@@@@@@@@@@@@@@@@@@@@@@@......@@@@@@@@@@@@......@@@@@@@@@@@@@....@@@@@@@@@@@@@....................@@@@@@@@@@..............................................................@@@@......................................@@....................@@.....@@@@@@@@@@@@@@@@@@@@@@@@@@@@@@@@@@.......@@@............@@@@@@...........@@@@@@@@@@@@..................@@@@@...@@@@@@@@@@@@..@@@@@@@@@@@@@@@@@@@@@@@@@@@@@@..@@@@@@@@@@@@@@@@@@@@@@@@@@.....................................XXX@@@...........................==@@XXXXXX............XXX.....................@@@@@@@@@@@@----@@.......
..................I.........................................................@@@@@@@@...............................................................................................@@......................@@............................@@..............................................................++++++++...................@@@@@@......................................@@....................@@.............................................@@@@............@@@@@@...........@@@@@/\@@@@@..................@@@@@..............................................................................................................XXXXX@@@====.....................====@@XXXXXXX...........XXX.....................@@@@@@@@@@@@....@@.......
..................I.......................................................@@@@@@@@@@@@..........................+++++++++++++++.....................................................@@....................@@..............................@@........................................................+++++########+++++............@@@@@@@@......................................@@....................@@............................................@@@@@............@@@@@@...........@@@@]..[@@@@..................@@@@@......................................................................................XXXX...................XXXXXX@@@@@@@@@@@@@@@@@....@@@@@@@@@@@@@XXXXXXX.........XXXXX.......X............XX@@@@@..@@@@....@@.......
.................@@@@@@@@@@@@...........aabbccdd........................@@@@@@@@@@@@@@@@................++++++++###############++++++++++............................................@@..................@@................................@@.................................................++++++##################++++++....@@@@@@@@@@.........@@@@@........................@@....................@@...........................................@@@@@@............@@@@@@...........@@@@]..[@@@@..................@@@@@...................................................................................XXXXXXXXX........XXXX...XXXXXXXX@@@@@@@@@@@@@@@@@....XXXXXXXXXXXXXXXXXXXXX........XXXXXX......XX...........XXXX@@@..@@@@....@@.......
+++@@------------@@@@@@@@@@@@+++++++++++++++++++++++++++++++++++++++++++@@@@@@@@@@@@@@@@++++++++++++++++#################################+++++++++@@@@@@@@@@@@@@@@@@@@@@@@@@@@@@@@@@@@@@@@@@@@@@@@@@@@@@@@@@@@@@@@@@@@@@@@@@@@@@@@@@@@@@@@@@@@@@@@@@@@@@@@@@@@@@@@@@@@@@@@++++++++++++++++++++##############################++@@@@@@@@@@@@@@@@@@@@@@@@@@@@@@@@@@@@@@@@@@@@@@@@@@@@....................@@@@@@@@@@@@@@@@@@@@@@@@@@@@@@@@@@@@@@@@@@@@@@@@@@@............@@@@@@...........@@@@@@@@@@@@..................@@@@@@@@@@@@@@@@@@@@@@@@@@@@@@@@@@@@@@@@@@@@@@@@@@@@@@@@@@@@@@@@@@@@@@@@@@@@@@@.....XXXXXXXXXXXXXXXXX..XXXXXXXXXXXXXXXXXXXXXXXXXXXXXXXXXX....XXXXXXXXXXXXXXXXXXXXX.......XXXXXXX.....XXXX.........XXXXX@@@@@@@@@....@@.......

a - 1
b @ 1
c | 0
d I 0
e @ 1
