@@@@@@@@@@@@@@@@@@@.....................
@@@@@@@/........[@@.....................
@@@@@@/.........[@@.....................
@@@@@]....[@@]..[@@.....................
@@@@@]....[@@]..[@@.....................
@@@@@]....[@@]..[@@.....................
@@@@@]....[@@]..[@@.....................
@@@@@]....[@@/..\@@.....................
@@@@@]....[@]....[@.....................
@@@@@]....[[]....[@.....................
@@@@@]....[@/....\@.....................
@@@@@]....[]......I.....................
@@@@@]....[]......I.....................
..........[]......I.....................
..........[]......I.....................
@@@@@@@@@@@@@@@@@@@@@@@@@@@@@@@@@@@@@@@@

